NUTS1;NUTS2;NUTS3;LAU2_CODE;LAU2_NAME;AGE_GROUP;POP_TOTAL;POP_MALE;POP_FEMALE;YEAR
AT1;AT12;AT124;30101;Krems an der Donau;0_4;1124;588;536;2021
AT1;AT12;AT124;30101;Krems an der Donau;5_9;922;465;457;2021
AT1;AT12;AT124;30101;Krems an der Donau;10_14;1030;550;480;2021
AT1;AT12;AT124;30101;Krems an der Donau;15_19;1099;541;558;2021
AT1;AT12;AT124;30101;Krems an der Donau;20_24;1458;751;707;2021
AT1;AT12;AT124;30101;Krems an der Donau;25_29;1647;883;764;2021
AT1;AT12;AT124;30101;Krems an der Donau;30_34;1584;872;712;2021
AT1;AT12;AT124;30101;Krems an der Donau;35_39;1639;890;749;2021
AT1;AT12;AT124;30101;Krems an der Donau;40_44;1431;719;712;2021
AT1;AT12;AT124;30101;Krems an der Donau;45_49;1633;810;823;2021
AT1;AT12;AT124;30101;Krems an der Donau;50_54;1963;1019;944;2021
AT1;AT12;AT124;30101;Krems an der Donau;55_59;1953;913;1040;2021
AT1;AT12;AT124;30101;Krems an der Donau;60_64;1848;872;976;2021
AT1;AT12;AT124;30101;Krems an der Donau;65_69;1341;621;720;2021
AT1;AT12;AT124;30101;Krems an der Donau;70_74;1287;551;736;2021
AT1;AT12;AT124;30101;Krems an der Donau;75_79;1215;533;682;2021
AT1;AT12;AT124;30101;Krems an der Donau;80_84;901;384;517;2021
AT1;AT12;AT124;30101;Krems an der Donau;85_89;448;146;302;2021
AT1;AT12;AT124;30101;Krems an der Donau;90_94;239;67;172;2021
AT1;AT12;AT124;30101;Krems an der Donau;95_;75;20;55;2021
AT1;AT12;AT123;30201;St. P�lten;0_4;2558;1310;1248;2021
AT1;AT12;AT123;30201;St. P�lten;5_9;2574;1339;1235;2021
AT1;AT12;AT123;30201;St. P�lten;10_14;2652;1334;1318;2021
AT1;AT12;AT123;30201;St. P�lten;15_19;3006;1603;1403;2021
AT1;AT12;AT123;30201;St. P�lten;20_24;3201;1678;1523;2021
AT1;AT12;AT123;30201;St. P�lten;25_29;3682;1856;1826;2021
AT1;AT12;AT123;30201;St. P�lten;30_34;3742;1940;1802;2021
AT1;AT12;AT123;30201;St. P�lten;35_39;3769;1934;1835;2021
AT1;AT12;AT123;30201;St. P�lten;40_44;3439;1741;1698;2021
AT1;AT12;AT123;30201;St. P�lten;45_49;3734;1844;1890;2021
AT1;AT12;AT123;30201;St. P�lten;50_54;4471;2197;2274;2021
AT1;AT12;AT123;30201;St. P�lten;55_59;4347;2119;2228;2021
AT1;AT12;AT123;30201;St. P�lten;60_64;3578;1743;1835;2021
AT1;AT12;AT123;30201;St. P�lten;65_69;2802;1293;1509;2021
AT1;AT12;AT123;30201;St. P�lten;70_74;2600;1143;1457;2021
AT1;AT12;AT123;30201;St. P�lten;75_79;2244;977;1267;2021
AT1;AT12;AT123;30201;St. P�lten;80_84;1887;804;1083;2021
AT1;AT12;AT123;30201;St. P�lten;85_89;948;344;604;2021
AT1;AT12;AT123;30201;St. P�lten;90_94;501;170;331;2021
AT1;AT12;AT123;30201;St. P�lten;95_;143;32;111;2021
AT1;AT12;AT121;30301;Waidhofen an der Ybbs;0_4;537;288;249;2021
AT1;AT12;AT121;30301;Waidhofen an der Ybbs;5_9;554;280;274;2021
AT1;AT12;AT121;30301;Waidhofen an der Ybbs;10_14;562;298;264;2021
AT1;AT12;AT121;30301;Waidhofen an der Ybbs;15_19;591;318;273;2021
AT1;AT12;AT121;30301;Waidhofen an der Ybbs;20_24;651;351;300;2021
AT1;AT12;AT121;30301;Waidhofen an der Ybbs;25_29;670;386;284;2021
AT1;AT12;AT121;30301;Waidhofen an der Ybbs;30_34;667;331;336;2021
AT1;AT12;AT121;30301;Waidhofen an der Ybbs;35_39;659;331;328;2021
AT1;AT12;AT121;30301;Waidhofen an der Ybbs;40_44;628;314;314;2021
AT1;AT12;AT121;30301;Waidhofen an der Ybbs;45_49;750;375;375;2021
AT1;AT12;AT121;30301;Waidhofen an der Ybbs;50_54;837;430;407;2021
AT1;AT12;AT121;30301;Waidhofen an der Ybbs;55_59;864;407;457;2021
AT1;AT12;AT121;30301;Waidhofen an der Ybbs;60_64;749;362;387;2021
AT1;AT12;AT121;30301;Waidhofen an der Ybbs;65_69;618;299;319;2021
AT1;AT12;AT121;30301;Waidhofen an der Ybbs;70_74;507;229;278;2021
AT1;AT12;AT121;30301;Waidhofen an der Ybbs;75_79;426;182;244;2021
AT1;AT12;AT121;30301;Waidhofen an der Ybbs;80_84;449;196;253;2021
AT1;AT12;AT121;30301;Waidhofen an der Ybbs;85_89;238;81;157;2021
AT1;AT12;AT121;30301;Waidhofen an der Ybbs;90_94;123;35;88;2021
AT1;AT12;AT121;30301;Waidhofen an der Ybbs;95_;54;18;36;2021
AT1;AT12;AT122;30401;Wiener Neustadt;0_4;2515;1311;1204;2021
AT1;AT12;AT122;30401;Wiener Neustadt;5_9;2358;1188;1170;2021
AT1;AT12;AT122;30401;Wiener Neustadt;10_14;2380;1197;1183;2021
AT1;AT12;AT122;30401;Wiener Neustadt;15_19;2523;1316;1207;2021
AT1;AT12;AT122;30401;Wiener Neustadt;20_24;2846;1467;1379;2021
AT1;AT12;AT122;30401;Wiener Neustadt;25_29;3311;1669;1642;2021
AT1;AT12;AT122;30401;Wiener Neustadt;30_34;3418;1765;1653;2021
AT1;AT12;AT122;30401;Wiener Neustadt;35_39;3272;1636;1636;2021
AT1;AT12;AT122;30401;Wiener Neustadt;40_44;3049;1527;1522;2021
AT1;AT12;AT122;30401;Wiener Neustadt;45_49;3130;1520;1610;2021
AT1;AT12;AT122;30401;Wiener Neustadt;50_54;3542;1715;1827;2021
AT1;AT12;AT122;30401;Wiener Neustadt;55_59;3380;1645;1735;2021
AT1;AT12;AT122;30401;Wiener Neustadt;60_64;2801;1359;1442;2021
AT1;AT12;AT122;30401;Wiener Neustadt;65_69;2092;935;1157;2021
AT1;AT12;AT122;30401;Wiener Neustadt;70_74;1933;823;1110;2021
AT1;AT12;AT122;30401;Wiener Neustadt;75_79;1688;754;934;2021
AT1;AT12;AT122;30401;Wiener Neustadt;80_84;1213;505;708;2021
AT1;AT12;AT122;30401;Wiener Neustadt;85_89;618;209;409;2021
AT1;AT12;AT122;30401;Wiener Neustadt;90_94;312;84;228;2021
AT1;AT12;AT122;30401;Wiener Neustadt;95_;75;16;59;2021
AT1;AT12;AT121;30501;Allhartsberg;0_4;119;58;61;2021
AT1;AT12;AT121;30501;Allhartsberg;5_9;130;61;69;2021
AT1;AT12;AT121;30501;Allhartsberg;10_14;134;71;63;2021
AT1;AT12;AT121;30501;Allhartsberg;15_19;122;64;58;2021
AT1;AT12;AT121;30501;Allhartsberg;20_24;121;63;58;2021
AT1;AT12;AT121;30501;Allhartsberg;25_29;138;69;69;2021
AT1;AT12;AT121;30501;Allhartsberg;30_34;147;76;71;2021
AT1;AT12;AT121;30501;Allhartsberg;35_39;164;81;83;2021
AT1;AT12;AT121;30501;Allhartsberg;40_44;152;81;71;2021
AT1;AT12;AT121;30501;Allhartsberg;45_49;162;80;82;2021
AT1;AT12;AT121;30501;Allhartsberg;50_54;127;67;60;2021
AT1;AT12;AT121;30501;Allhartsberg;55_59;160;88;72;2021
AT1;AT12;AT121;30501;Allhartsberg;60_64;149;72;77;2021
AT1;AT12;AT121;30501;Allhartsberg;65_69;112;53;59;2021
AT1;AT12;AT121;30501;Allhartsberg;70_74;94;51;43;2021
AT1;AT12;AT121;30501;Allhartsberg;75_79;49;24;25;2021
AT1;AT12;AT121;30501;Allhartsberg;80_84;51;22;29;2021
AT1;AT12;AT121;30501;Allhartsberg;85_89;30;10;20;2021
AT1;AT12;AT121;30501;Allhartsberg;90_94;17;7;10;2021
AT1;AT12;AT121;30501;Allhartsberg;95_;2;0;2;2021
AT1;AT12;AT121;30502;Amstetten;0_4;1146;583;563;2021
AT1;AT12;AT121;30502;Amstetten;5_9;1094;583;511;2021
AT1;AT12;AT121;30502;Amstetten;10_14;1189;620;569;2021
AT1;AT12;AT121;30502;Amstetten;15_19;1150;573;577;2021
AT1;AT12;AT121;30502;Amstetten;20_24;1410;739;671;2021
AT1;AT12;AT121;30502;Amstetten;25_29;1525;804;721;2021
AT1;AT12;AT121;30502;Amstetten;30_34;1605;796;809;2021
AT1;AT12;AT121;30502;Amstetten;35_39;1523;799;724;2021
AT1;AT12;AT121;30502;Amstetten;40_44;1331;672;659;2021
AT1;AT12;AT121;30502;Amstetten;45_49;1586;796;790;2021
AT1;AT12;AT121;30502;Amstetten;50_54;1864;928;936;2021
AT1;AT12;AT121;30502;Amstetten;55_59;1985;976;1009;2021
AT1;AT12;AT121;30502;Amstetten;60_64;1632;783;849;2021
AT1;AT12;AT121;30502;Amstetten;65_69;1200;563;637;2021
AT1;AT12;AT121;30502;Amstetten;70_74;1043;456;587;2021
AT1;AT12;AT121;30502;Amstetten;75_79;871;360;511;2021
AT1;AT12;AT121;30502;Amstetten;80_84;775;331;444;2021
AT1;AT12;AT121;30502;Amstetten;85_89;407;138;269;2021
AT1;AT12;AT121;30502;Amstetten;90_94;177;56;121;2021
AT1;AT12;AT121;30502;Amstetten;95_;56;8;48;2021
AT1;AT12;AT121;30503;Ardagger;0_4;208;113;95;2021
AT1;AT12;AT121;30503;Ardagger;5_9;206;116;90;2021
AT1;AT12;AT121;30503;Ardagger;10_14;190;85;105;2021
AT1;AT12;AT121;30503;Ardagger;15_19;214;120;94;2021
AT1;AT12;AT121;30503;Ardagger;20_24;204;103;101;2021
AT1;AT12;AT121;30503;Ardagger;25_29;201;108;93;2021
AT1;AT12;AT121;30503;Ardagger;30_34;210;112;98;2021
AT1;AT12;AT121;30503;Ardagger;35_39;254;117;137;2021
AT1;AT12;AT121;30503;Ardagger;40_44;222;118;104;2021
AT1;AT12;AT121;30503;Ardagger;45_49;254;119;135;2021
AT1;AT12;AT121;30503;Ardagger;50_54;250;144;106;2021
AT1;AT12;AT121;30503;Ardagger;55_59;280;139;141;2021
AT1;AT12;AT121;30503;Ardagger;60_64;220;120;100;2021
AT1;AT12;AT121;30503;Ardagger;65_69;212;97;115;2021
AT1;AT12;AT121;30503;Ardagger;70_74;144;79;65;2021
AT1;AT12;AT121;30503;Ardagger;75_79;98;41;57;2021
AT1;AT12;AT121;30503;Ardagger;80_84;104;49;55;2021
AT1;AT12;AT121;30503;Ardagger;85_89;39;13;26;2021
AT1;AT12;AT121;30503;Ardagger;90_94;22;8;14;2021
AT1;AT12;AT121;30503;Ardagger;95_;4;1;3;2021
AT1;AT12;AT121;30504;Aschbach-Markt;0_4;193;105;88;2021
AT1;AT12;AT121;30504;Aschbach-Markt;5_9;210;103;107;2021
AT1;AT12;AT121;30504;Aschbach-Markt;10_14;199;94;105;2021
AT1;AT12;AT121;30504;Aschbach-Markt;15_19;205;111;94;2021
AT1;AT12;AT121;30504;Aschbach-Markt;20_24;240;124;116;2021
AT1;AT12;AT121;30504;Aschbach-Markt;25_29;248;141;107;2021
AT1;AT12;AT121;30504;Aschbach-Markt;30_34;232;120;112;2021
AT1;AT12;AT121;30504;Aschbach-Markt;35_39;259;122;137;2021
AT1;AT12;AT121;30504;Aschbach-Markt;40_44;236;120;116;2021
AT1;AT12;AT121;30504;Aschbach-Markt;45_49;260;133;127;2021
AT1;AT12;AT121;30504;Aschbach-Markt;50_54;291;129;162;2021
AT1;AT12;AT121;30504;Aschbach-Markt;55_59;289;147;142;2021
AT1;AT12;AT121;30504;Aschbach-Markt;60_64;255;136;119;2021
AT1;AT12;AT121;30504;Aschbach-Markt;65_69;185;94;91;2021
AT1;AT12;AT121;30504;Aschbach-Markt;70_74;152;73;79;2021
AT1;AT12;AT121;30504;Aschbach-Markt;75_79;133;60;73;2021
AT1;AT12;AT121;30504;Aschbach-Markt;80_84;116;51;65;2021
AT1;AT12;AT121;30504;Aschbach-Markt;85_89;61;24;37;2021
AT1;AT12;AT121;30504;Aschbach-Markt;90_94;20;8;12;2021
AT1;AT12;AT121;30504;Aschbach-Markt;95_;1;0;1;2021
AT1;AT12;AT121;30506;Behamberg;0_4;209;100;109;2021
AT1;AT12;AT121;30506;Behamberg;5_9;215;104;111;2021
AT1;AT12;AT121;30506;Behamberg;10_14;164;93;71;2021
AT1;AT12;AT121;30506;Behamberg;15_19;183;107;76;2021
AT1;AT12;AT121;30506;Behamberg;20_24;175;94;81;2021
AT1;AT12;AT121;30506;Behamberg;25_29;216;99;117;2021
AT1;AT12;AT121;30506;Behamberg;30_34;229;136;93;2021
AT1;AT12;AT121;30506;Behamberg;35_39;254;127;127;2021
AT1;AT12;AT121;30506;Behamberg;40_44;230;114;116;2021
AT1;AT12;AT121;30506;Behamberg;45_49;226;126;100;2021
AT1;AT12;AT121;30506;Behamberg;50_54;257;132;125;2021
AT1;AT12;AT121;30506;Behamberg;55_59;267;136;131;2021
AT1;AT12;AT121;30506;Behamberg;60_64;234;121;113;2021
AT1;AT12;AT121;30506;Behamberg;65_69;159;74;85;2021
AT1;AT12;AT121;30506;Behamberg;70_74;153;77;76;2021
AT1;AT12;AT121;30506;Behamberg;75_79;109;49;60;2021
AT1;AT12;AT121;30506;Behamberg;80_84;108;51;57;2021
AT1;AT12;AT121;30506;Behamberg;85_89;49;28;21;2021
AT1;AT12;AT121;30506;Behamberg;90_94;15;8;7;2021
AT1;AT12;AT121;30506;Behamberg;95_;3;0;3;2021
AT1;AT12;AT121;30507;Biberbach;0_4;139;69;70;2021
AT1;AT12;AT121;30507;Biberbach;5_9;118;66;52;2021
AT1;AT12;AT121;30507;Biberbach;10_14;124;56;68;2021
AT1;AT12;AT121;30507;Biberbach;15_19;131;78;53;2021
AT1;AT12;AT121;30507;Biberbach;20_24;139;71;68;2021
AT1;AT12;AT121;30507;Biberbach;25_29;170;84;86;2021
AT1;AT12;AT121;30507;Biberbach;30_34;133;59;74;2021
AT1;AT12;AT121;30507;Biberbach;35_39;174;92;82;2021
AT1;AT12;AT121;30507;Biberbach;40_44;147;71;76;2021
AT1;AT12;AT121;30507;Biberbach;45_49;151;81;70;2021
AT1;AT12;AT121;30507;Biberbach;50_54;158;79;79;2021
AT1;AT12;AT121;30507;Biberbach;55_59;189;93;96;2021
AT1;AT12;AT121;30507;Biberbach;60_64;153;78;75;2021
AT1;AT12;AT121;30507;Biberbach;65_69;107;61;46;2021
AT1;AT12;AT121;30507;Biberbach;70_74;76;37;39;2021
AT1;AT12;AT121;30507;Biberbach;75_79;56;23;33;2021
AT1;AT12;AT121;30507;Biberbach;80_84;64;29;35;2021
AT1;AT12;AT121;30507;Biberbach;85_89;34;15;19;2021
AT1;AT12;AT121;30507;Biberbach;90_94;18;6;12;2021
AT1;AT12;AT121;30507;Biberbach;95_;3;0;3;2021
AT1;AT12;AT121;30508;Ennsdorf;0_4;149;87;62;2021
AT1;AT12;AT121;30508;Ennsdorf;5_9;160;82;78;2021
AT1;AT12;AT121;30508;Ennsdorf;10_14;196;109;87;2021
AT1;AT12;AT121;30508;Ennsdorf;15_19;188;94;94;2021
AT1;AT12;AT121;30508;Ennsdorf;20_24;185;93;92;2021
AT1;AT12;AT121;30508;Ennsdorf;25_29;204;104;100;2021
AT1;AT12;AT121;30508;Ennsdorf;30_34;180;80;100;2021
AT1;AT12;AT121;30508;Ennsdorf;35_39;227;111;116;2021
AT1;AT12;AT121;30508;Ennsdorf;40_44;185;90;95;2021
AT1;AT12;AT121;30508;Ennsdorf;45_49;269;129;140;2021
AT1;AT12;AT121;30508;Ennsdorf;50_54;224;126;98;2021
AT1;AT12;AT121;30508;Ennsdorf;55_59;252;133;119;2021
AT1;AT12;AT121;30508;Ennsdorf;60_64;177;86;91;2021
AT1;AT12;AT121;30508;Ennsdorf;65_69;138;64;74;2021
AT1;AT12;AT121;30508;Ennsdorf;70_74;116;54;62;2021
AT1;AT12;AT121;30508;Ennsdorf;75_79;98;34;64;2021
AT1;AT12;AT121;30508;Ennsdorf;80_84;94;45;49;2021
AT1;AT12;AT121;30508;Ennsdorf;85_89;40;12;28;2021
AT1;AT12;AT121;30508;Ennsdorf;90_94;11;1;10;2021
AT1;AT12;AT121;30508;Ennsdorf;95_;1;0;1;2021
AT1;AT12;AT121;30509;Ernsthofen;0_4;106;47;59;2021
AT1;AT12;AT121;30509;Ernsthofen;5_9;101;42;59;2021
AT1;AT12;AT121;30509;Ernsthofen;10_14;116;57;59;2021
AT1;AT12;AT121;30509;Ernsthofen;15_19;130;53;77;2021
AT1;AT12;AT121;30509;Ernsthofen;20_24;141;76;65;2021
AT1;AT12;AT121;30509;Ernsthofen;25_29;137;69;68;2021
AT1;AT12;AT121;30509;Ernsthofen;30_34;147;71;76;2021
AT1;AT12;AT121;30509;Ernsthofen;35_39;125;74;51;2021
AT1;AT12;AT121;30509;Ernsthofen;40_44;174;84;90;2021
AT1;AT12;AT121;30509;Ernsthofen;45_49;158;94;64;2021
AT1;AT12;AT121;30509;Ernsthofen;50_54;188;94;94;2021
AT1;AT12;AT121;30509;Ernsthofen;55_59;181;89;92;2021
AT1;AT12;AT121;30509;Ernsthofen;60_64;168;91;77;2021
AT1;AT12;AT121;30509;Ernsthofen;65_69;130;67;63;2021
AT1;AT12;AT121;30509;Ernsthofen;70_74;91;39;52;2021
AT1;AT12;AT121;30509;Ernsthofen;75_79;65;28;37;2021
AT1;AT12;AT121;30509;Ernsthofen;80_84;70;29;41;2021
AT1;AT12;AT121;30509;Ernsthofen;85_89;42;19;23;2021
AT1;AT12;AT121;30509;Ernsthofen;90_94;12;8;4;2021
AT1;AT12;AT121;30509;Ernsthofen;95_;4;1;3;2021
AT1;AT12;AT121;30510;Ertl;0_4;72;33;39;2021
AT1;AT12;AT121;30510;Ertl;5_9;58;35;23;2021
AT1;AT12;AT121;30510;Ertl;10_14;85;49;36;2021
AT1;AT12;AT121;30510;Ertl;15_19;91;53;38;2021
AT1;AT12;AT121;30510;Ertl;20_24;84;40;44;2021
AT1;AT12;AT121;30510;Ertl;25_29;71;31;40;2021
AT1;AT12;AT121;30510;Ertl;30_34;86;52;34;2021
AT1;AT12;AT121;30510;Ertl;35_39;81;42;39;2021
AT1;AT12;AT121;30510;Ertl;40_44;76;40;36;2021
AT1;AT12;AT121;30510;Ertl;45_49;94;50;44;2021
AT1;AT12;AT121;30510;Ertl;50_54;96;49;47;2021
AT1;AT12;AT121;30510;Ertl;55_59;113;60;53;2021
AT1;AT12;AT121;30510;Ertl;60_64;78;45;33;2021
AT1;AT12;AT121;30510;Ertl;65_69;49;23;26;2021
AT1;AT12;AT121;30510;Ertl;70_74;40;21;19;2021
AT1;AT12;AT121;30510;Ertl;75_79;24;8;16;2021
AT1;AT12;AT121;30510;Ertl;80_84;38;19;19;2021
AT1;AT12;AT121;30510;Ertl;85_89;18;5;13;2021
AT1;AT12;AT121;30510;Ertl;90_94;5;2;3;2021
AT1;AT12;AT121;30510;Ertl;95_;0;0;0;2021
AT1;AT12;AT121;30511;Euratsfeld;0_4;176;94;82;2021
AT1;AT12;AT121;30511;Euratsfeld;5_9;159;88;71;2021
AT1;AT12;AT121;30511;Euratsfeld;10_14;176;84;92;2021
AT1;AT12;AT121;30511;Euratsfeld;15_19;150;91;59;2021
AT1;AT12;AT121;30511;Euratsfeld;20_24;138;63;75;2021
AT1;AT12;AT121;30511;Euratsfeld;25_29;165;83;82;2021
AT1;AT12;AT121;30511;Euratsfeld;30_34;183;97;86;2021
AT1;AT12;AT121;30511;Euratsfeld;35_39;193;91;102;2021
AT1;AT12;AT121;30511;Euratsfeld;40_44;193;97;96;2021
AT1;AT12;AT121;30511;Euratsfeld;45_49;162;76;86;2021
AT1;AT12;AT121;30511;Euratsfeld;50_54;207;108;99;2021
AT1;AT12;AT121;30511;Euratsfeld;55_59;219;118;101;2021
AT1;AT12;AT121;30511;Euratsfeld;60_64;170;85;85;2021
AT1;AT12;AT121;30511;Euratsfeld;65_69;136;70;66;2021
AT1;AT12;AT121;30511;Euratsfeld;70_74;74;38;36;2021
AT1;AT12;AT121;30511;Euratsfeld;75_79;67;33;34;2021
AT1;AT12;AT121;30511;Euratsfeld;80_84;75;28;47;2021
AT1;AT12;AT121;30511;Euratsfeld;85_89;25;5;20;2021
AT1;AT12;AT121;30511;Euratsfeld;90_94;13;7;6;2021
AT1;AT12;AT121;30511;Euratsfeld;95_;5;3;2;2021
AT1;AT12;AT121;30512;Ferschnitz;0_4;116;66;50;2021
AT1;AT12;AT121;30512;Ferschnitz;5_9;108;56;52;2021
AT1;AT12;AT121;30512;Ferschnitz;10_14;92;50;42;2021
AT1;AT12;AT121;30512;Ferschnitz;15_19;92;52;40;2021
AT1;AT12;AT121;30512;Ferschnitz;20_24;99;46;53;2021
AT1;AT12;AT121;30512;Ferschnitz;25_29;135;70;65;2021
AT1;AT12;AT121;30512;Ferschnitz;30_34;149;78;71;2021
AT1;AT12;AT121;30512;Ferschnitz;35_39;150;69;81;2021
AT1;AT12;AT121;30512;Ferschnitz;40_44;104;54;50;2021
AT1;AT12;AT121;30512;Ferschnitz;45_49;112;62;50;2021
AT1;AT12;AT121;30512;Ferschnitz;50_54;149;70;79;2021
AT1;AT12;AT121;30512;Ferschnitz;55_59;141;71;70;2021
AT1;AT12;AT121;30512;Ferschnitz;60_64;122;66;56;2021
AT1;AT12;AT121;30512;Ferschnitz;65_69;75;41;34;2021
AT1;AT12;AT121;30512;Ferschnitz;70_74;72;38;34;2021
AT1;AT12;AT121;30512;Ferschnitz;75_79;49;22;27;2021
AT1;AT12;AT121;30512;Ferschnitz;80_84;42;16;26;2021
AT1;AT12;AT121;30512;Ferschnitz;85_89;23;11;12;2021
AT1;AT12;AT121;30512;Ferschnitz;90_94;4;2;2;2021
AT1;AT12;AT121;30512;Ferschnitz;95_;2;0;2;2021
AT1;AT12;AT121;30514;Haag;0_4;270;138;132;2021
AT1;AT12;AT121;30514;Haag;5_9;273;156;117;2021
AT1;AT12;AT121;30514;Haag;10_14;293;144;149;2021
AT1;AT12;AT121;30514;Haag;15_19;307;161;146;2021
AT1;AT12;AT121;30514;Haag;20_24;316;160;156;2021
AT1;AT12;AT121;30514;Haag;25_29;371;202;169;2021
AT1;AT12;AT121;30514;Haag;30_34;359;182;177;2021
AT1;AT12;AT121;30514;Haag;35_39;390;205;185;2021
AT1;AT12;AT121;30514;Haag;40_44;353;180;173;2021
AT1;AT12;AT121;30514;Haag;45_49;350;187;163;2021
AT1;AT12;AT121;30514;Haag;50_54;421;196;225;2021
AT1;AT12;AT121;30514;Haag;55_59;524;260;264;2021
AT1;AT12;AT121;30514;Haag;60_64;366;193;173;2021
AT1;AT12;AT121;30514;Haag;65_69;279;128;151;2021
AT1;AT12;AT121;30514;Haag;70_74;214;101;113;2021
AT1;AT12;AT121;30514;Haag;75_79;195;80;115;2021
AT1;AT12;AT121;30514;Haag;80_84;199;79;120;2021
AT1;AT12;AT121;30514;Haag;85_89;127;43;84;2021
AT1;AT12;AT121;30514;Haag;90_94;44;9;35;2021
AT1;AT12;AT121;30514;Haag;95_;5;1;4;2021
AT1;AT12;AT121;30515;Haidershofen;0_4;196;100;96;2021
AT1;AT12;AT121;30515;Haidershofen;5_9;197;95;102;2021
AT1;AT12;AT121;30515;Haidershofen;10_14;218;124;94;2021
AT1;AT12;AT121;30515;Haidershofen;15_19;211;117;94;2021
AT1;AT12;AT121;30515;Haidershofen;20_24;182;96;86;2021
AT1;AT12;AT121;30515;Haidershofen;25_29;222;106;116;2021
AT1;AT12;AT121;30515;Haidershofen;30_34;233;126;107;2021
AT1;AT12;AT121;30515;Haidershofen;35_39;217;105;112;2021
AT1;AT12;AT121;30515;Haidershofen;40_44;237;121;116;2021
AT1;AT12;AT121;30515;Haidershofen;45_49;245;118;127;2021
AT1;AT12;AT121;30515;Haidershofen;50_54;291;152;139;2021
AT1;AT12;AT121;30515;Haidershofen;55_59;324;172;152;2021
AT1;AT12;AT121;30515;Haidershofen;60_64;263;129;134;2021
AT1;AT12;AT121;30515;Haidershofen;65_69;193;100;93;2021
AT1;AT12;AT121;30515;Haidershofen;70_74;150;71;79;2021
AT1;AT12;AT121;30515;Haidershofen;75_79;117;53;64;2021
AT1;AT12;AT121;30515;Haidershofen;80_84;130;65;65;2021
AT1;AT12;AT121;30515;Haidershofen;85_89;65;22;43;2021
AT1;AT12;AT121;30515;Haidershofen;90_94;16;8;8;2021
AT1;AT12;AT121;30515;Haidershofen;95_;3;0;3;2021
AT1;AT12;AT121;30516;Hollenstein an der Ybbs;0_4;101;60;41;2021
AT1;AT12;AT121;30516;Hollenstein an der Ybbs;5_9;78;44;34;2021
AT1;AT12;AT121;30516;Hollenstein an der Ybbs;10_14;93;44;49;2021
AT1;AT12;AT121;30516;Hollenstein an der Ybbs;15_19;93;39;54;2021
AT1;AT12;AT121;30516;Hollenstein an der Ybbs;20_24;75;38;37;2021
AT1;AT12;AT121;30516;Hollenstein an der Ybbs;25_29;97;50;47;2021
AT1;AT12;AT121;30516;Hollenstein an der Ybbs;30_34;95;44;51;2021
AT1;AT12;AT121;30516;Hollenstein an der Ybbs;35_39;96;52;44;2021
AT1;AT12;AT121;30516;Hollenstein an der Ybbs;40_44;100;56;44;2021
AT1;AT12;AT121;30516;Hollenstein an der Ybbs;45_49;99;53;46;2021
AT1;AT12;AT121;30516;Hollenstein an der Ybbs;50_54;108;50;58;2021
AT1;AT12;AT121;30516;Hollenstein an der Ybbs;55_59;120;64;56;2021
AT1;AT12;AT121;30516;Hollenstein an der Ybbs;60_64;130;63;67;2021
AT1;AT12;AT121;30516;Hollenstein an der Ybbs;65_69;114;61;53;2021
AT1;AT12;AT121;30516;Hollenstein an der Ybbs;70_74;87;39;48;2021
AT1;AT12;AT121;30516;Hollenstein an der Ybbs;75_79;60;20;40;2021
AT1;AT12;AT121;30516;Hollenstein an der Ybbs;80_84;70;34;36;2021
AT1;AT12;AT121;30516;Hollenstein an der Ybbs;85_89;35;16;19;2021
AT1;AT12;AT121;30516;Hollenstein an der Ybbs;90_94;18;9;9;2021
AT1;AT12;AT121;30516;Hollenstein an der Ybbs;95_;5;3;2;2021
AT1;AT12;AT121;30517;Kematen an der Ybbs;0_4;117;58;59;2021
AT1;AT12;AT121;30517;Kematen an der Ybbs;5_9;141;64;77;2021
AT1;AT12;AT121;30517;Kematen an der Ybbs;10_14;134;69;65;2021
AT1;AT12;AT121;30517;Kematen an der Ybbs;15_19;152;71;81;2021
AT1;AT12;AT121;30517;Kematen an der Ybbs;20_24;132;72;60;2021
AT1;AT12;AT121;30517;Kematen an der Ybbs;25_29;153;66;87;2021
AT1;AT12;AT121;30517;Kematen an der Ybbs;30_34;182;88;94;2021
AT1;AT12;AT121;30517;Kematen an der Ybbs;35_39;168;93;75;2021
AT1;AT12;AT121;30517;Kematen an der Ybbs;40_44;168;92;76;2021
AT1;AT12;AT121;30517;Kematen an der Ybbs;45_49;176;82;94;2021
AT1;AT12;AT121;30517;Kematen an der Ybbs;50_54;189;95;94;2021
AT1;AT12;AT121;30517;Kematen an der Ybbs;55_59;210;104;106;2021
AT1;AT12;AT121;30517;Kematen an der Ybbs;60_64;217;95;122;2021
AT1;AT12;AT121;30517;Kematen an der Ybbs;65_69;146;70;76;2021
AT1;AT12;AT121;30517;Kematen an der Ybbs;70_74;125;53;72;2021
AT1;AT12;AT121;30517;Kematen an der Ybbs;75_79;88;48;40;2021
AT1;AT12;AT121;30517;Kematen an der Ybbs;80_84;74;28;46;2021
AT1;AT12;AT121;30517;Kematen an der Ybbs;85_89;71;26;45;2021
AT1;AT12;AT121;30517;Kematen an der Ybbs;90_94;24;8;16;2021
AT1;AT12;AT121;30517;Kematen an der Ybbs;95_;3;1;2;2021
AT1;AT12;AT121;30520;Neuhofen an der Ybbs;0_4;193;99;94;2021
AT1;AT12;AT121;30520;Neuhofen an der Ybbs;5_9;194;109;85;2021
AT1;AT12;AT121;30520;Neuhofen an der Ybbs;10_14;191;94;97;2021
AT1;AT12;AT121;30520;Neuhofen an der Ybbs;15_19;202;115;87;2021
AT1;AT12;AT121;30520;Neuhofen an der Ybbs;20_24;149;90;59;2021
AT1;AT12;AT121;30520;Neuhofen an der Ybbs;25_29;174;93;81;2021
AT1;AT12;AT121;30520;Neuhofen an der Ybbs;30_34;186;92;94;2021
AT1;AT12;AT121;30520;Neuhofen an der Ybbs;35_39;219;107;112;2021
AT1;AT12;AT121;30520;Neuhofen an der Ybbs;40_44;188;105;83;2021
AT1;AT12;AT121;30520;Neuhofen an der Ybbs;45_49;229;126;103;2021
AT1;AT12;AT121;30520;Neuhofen an der Ybbs;50_54;210;96;114;2021
AT1;AT12;AT121;30520;Neuhofen an der Ybbs;55_59;199;105;94;2021
AT1;AT12;AT121;30520;Neuhofen an der Ybbs;60_64;194;88;106;2021
AT1;AT12;AT121;30520;Neuhofen an der Ybbs;65_69;154;83;71;2021
AT1;AT12;AT121;30520;Neuhofen an der Ybbs;70_74;117;60;57;2021
AT1;AT12;AT121;30520;Neuhofen an der Ybbs;75_79;66;25;41;2021
AT1;AT12;AT121;30520;Neuhofen an der Ybbs;80_84;82;40;42;2021
AT1;AT12;AT121;30520;Neuhofen an der Ybbs;85_89;33;16;17;2021
AT1;AT12;AT121;30520;Neuhofen an der Ybbs;90_94;14;0;14;2021
AT1;AT12;AT121;30520;Neuhofen an der Ybbs;95_;6;2;4;2021
AT1;AT12;AT121;30521;Neustadtl an der Donau;0_4;113;56;57;2021
AT1;AT12;AT121;30521;Neustadtl an der Donau;5_9;123;57;66;2021
AT1;AT12;AT121;30521;Neustadtl an der Donau;10_14;126;63;63;2021
AT1;AT12;AT121;30521;Neustadtl an der Donau;15_19;126;61;65;2021
AT1;AT12;AT121;30521;Neustadtl an der Donau;20_24;100;48;52;2021
AT1;AT12;AT121;30521;Neustadtl an der Donau;25_29;128;60;68;2021
AT1;AT12;AT121;30521;Neustadtl an der Donau;30_34;145;71;74;2021
AT1;AT12;AT121;30521;Neustadtl an der Donau;35_39;161;85;76;2021
AT1;AT12;AT121;30521;Neustadtl an der Donau;40_44;141;74;67;2021
AT1;AT12;AT121;30521;Neustadtl an der Donau;45_49;130;64;66;2021
AT1;AT12;AT121;30521;Neustadtl an der Donau;50_54;157;83;74;2021
AT1;AT12;AT121;30521;Neustadtl an der Donau;55_59;186;93;93;2021
AT1;AT12;AT121;30521;Neustadtl an der Donau;60_64;133;73;60;2021
AT1;AT12;AT121;30521;Neustadtl an der Donau;65_69;104;48;56;2021
AT1;AT12;AT121;30521;Neustadtl an der Donau;70_74;99;51;48;2021
AT1;AT12;AT121;30521;Neustadtl an der Donau;75_79;60;20;40;2021
AT1;AT12;AT121;30521;Neustadtl an der Donau;80_84;71;34;37;2021
AT1;AT12;AT121;30521;Neustadtl an der Donau;85_89;30;12;18;2021
AT1;AT12;AT121;30521;Neustadtl an der Donau;90_94;9;2;7;2021
AT1;AT12;AT121;30521;Neustadtl an der Donau;95_;1;0;1;2021
AT1;AT12;AT121;30522;Oed-Oehling;0_4;116;66;50;2021
AT1;AT12;AT121;30522;Oed-Oehling;5_9;105;57;48;2021
AT1;AT12;AT121;30522;Oed-Oehling;10_14;109;50;59;2021
AT1;AT12;AT121;30522;Oed-Oehling;15_19;94;39;55;2021
AT1;AT12;AT121;30522;Oed-Oehling;20_24;122;50;72;2021
AT1;AT12;AT121;30522;Oed-Oehling;25_29;143;79;64;2021
AT1;AT12;AT121;30522;Oed-Oehling;30_34;143;73;70;2021
AT1;AT12;AT121;30522;Oed-Oehling;35_39;156;73;83;2021
AT1;AT12;AT121;30522;Oed-Oehling;40_44;111;62;49;2021
AT1;AT12;AT121;30522;Oed-Oehling;45_49;139;64;75;2021
AT1;AT12;AT121;30522;Oed-Oehling;50_54;170;83;87;2021
AT1;AT12;AT121;30522;Oed-Oehling;55_59;148;76;72;2021
AT1;AT12;AT121;30522;Oed-Oehling;60_64;141;73;68;2021
AT1;AT12;AT121;30522;Oed-Oehling;65_69;89;50;39;2021
AT1;AT12;AT121;30522;Oed-Oehling;70_74;62;35;27;2021
AT1;AT12;AT121;30522;Oed-Oehling;75_79;51;26;25;2021
AT1;AT12;AT121;30522;Oed-Oehling;80_84;38;15;23;2021
AT1;AT12;AT121;30522;Oed-Oehling;85_89;21;5;16;2021
AT1;AT12;AT121;30522;Oed-Oehling;90_94;12;5;7;2021
AT1;AT12;AT121;30522;Oed-Oehling;95_;2;0;2;2021
AT1;AT12;AT121;30524;Opponitz;0_4;39;19;20;2021
AT1;AT12;AT121;30524;Opponitz;5_9;56;36;20;2021
AT1;AT12;AT121;30524;Opponitz;10_14;48;23;25;2021
AT1;AT12;AT121;30524;Opponitz;15_19;57;30;27;2021
AT1;AT12;AT121;30524;Opponitz;20_24;45;20;25;2021
AT1;AT12;AT121;30524;Opponitz;25_29;41;23;18;2021
AT1;AT12;AT121;30524;Opponitz;30_34;52;32;20;2021
AT1;AT12;AT121;30524;Opponitz;35_39;56;23;33;2021
AT1;AT12;AT121;30524;Opponitz;40_44;46;25;21;2021
AT1;AT12;AT121;30524;Opponitz;45_49;59;31;28;2021
AT1;AT12;AT121;30524;Opponitz;50_54;60;32;28;2021
AT1;AT12;AT121;30524;Opponitz;55_59;86;48;38;2021
AT1;AT12;AT121;30524;Opponitz;60_64;64;36;28;2021
AT1;AT12;AT121;30524;Opponitz;65_69;52;29;23;2021
AT1;AT12;AT121;30524;Opponitz;70_74;41;14;27;2021
AT1;AT12;AT121;30524;Opponitz;75_79;24;10;14;2021
AT1;AT12;AT121;30524;Opponitz;80_84;31;11;20;2021
AT1;AT12;AT121;30524;Opponitz;85_89;15;4;11;2021
AT1;AT12;AT121;30524;Opponitz;90_94;0;0;0;2021
AT1;AT12;AT121;30524;Opponitz;95_;3;0;3;2021
AT1;AT12;AT121;30526;St. Georgen am Reith;0_4;26;14;12;2021
AT1;AT12;AT121;30526;St. Georgen am Reith;5_9;23;16;7;2021
AT1;AT12;AT121;30526;St. Georgen am Reith;10_14;39;20;19;2021
AT1;AT12;AT121;30526;St. Georgen am Reith;15_19;29;16;13;2021
AT1;AT12;AT121;30526;St. Georgen am Reith;20_24;29;16;13;2021
AT1;AT12;AT121;30526;St. Georgen am Reith;25_29;42;23;19;2021
AT1;AT12;AT121;30526;St. Georgen am Reith;30_34;22;13;9;2021
AT1;AT12;AT121;30526;St. Georgen am Reith;35_39;35;21;14;2021
AT1;AT12;AT121;30526;St. Georgen am Reith;40_44;28;17;11;2021
AT1;AT12;AT121;30526;St. Georgen am Reith;45_49;30;13;17;2021
AT1;AT12;AT121;30526;St. Georgen am Reith;50_54;42;20;22;2021
AT1;AT12;AT121;30526;St. Georgen am Reith;55_59;33;15;18;2021
AT1;AT12;AT121;30526;St. Georgen am Reith;60_64;41;23;18;2021
AT1;AT12;AT121;30526;St. Georgen am Reith;65_69;37;22;15;2021
AT1;AT12;AT121;30526;St. Georgen am Reith;70_74;20;8;12;2021
AT1;AT12;AT121;30526;St. Georgen am Reith;75_79;19;9;10;2021
AT1;AT12;AT121;30526;St. Georgen am Reith;80_84;27;10;17;2021
AT1;AT12;AT121;30526;St. Georgen am Reith;85_89;15;9;6;2021
AT1;AT12;AT121;30526;St. Georgen am Reith;90_94;5;0;5;2021
AT1;AT12;AT121;30526;St. Georgen am Reith;95_;2;0;2;2021
AT1;AT12;AT121;30527;St. Georgen am Ybbsfelde;0_4;153;87;66;2021
AT1;AT12;AT121;30527;St. Georgen am Ybbsfelde;5_9;174;96;78;2021
AT1;AT12;AT121;30527;St. Georgen am Ybbsfelde;10_14;169;86;83;2021
AT1;AT12;AT121;30527;St. Georgen am Ybbsfelde;15_19;166;86;80;2021
AT1;AT12;AT121;30527;St. Georgen am Ybbsfelde;20_24;188;84;104;2021
AT1;AT12;AT121;30527;St. Georgen am Ybbsfelde;25_29;162;79;83;2021
AT1;AT12;AT121;30527;St. Georgen am Ybbsfelde;30_34;181;95;86;2021
AT1;AT12;AT121;30527;St. Georgen am Ybbsfelde;35_39;186;82;104;2021
AT1;AT12;AT121;30527;St. Georgen am Ybbsfelde;40_44;209;103;106;2021
AT1;AT12;AT121;30527;St. Georgen am Ybbsfelde;45_49;209;109;100;2021
AT1;AT12;AT121;30527;St. Georgen am Ybbsfelde;50_54;238;123;115;2021
AT1;AT12;AT121;30527;St. Georgen am Ybbsfelde;55_59;222;118;104;2021
AT1;AT12;AT121;30527;St. Georgen am Ybbsfelde;60_64;187;93;94;2021
AT1;AT12;AT121;30527;St. Georgen am Ybbsfelde;65_69;136;71;65;2021
AT1;AT12;AT121;30527;St. Georgen am Ybbsfelde;70_74;108;52;56;2021
AT1;AT12;AT121;30527;St. Georgen am Ybbsfelde;75_79;96;47;49;2021
AT1;AT12;AT121;30527;St. Georgen am Ybbsfelde;80_84;81;38;43;2021
AT1;AT12;AT121;30527;St. Georgen am Ybbsfelde;85_89;37;13;24;2021
AT1;AT12;AT121;30527;St. Georgen am Ybbsfelde;90_94;18;8;10;2021
AT1;AT12;AT121;30527;St. Georgen am Ybbsfelde;95_;6;2;4;2021
AT1;AT12;AT121;30529;St. Pantaleon-Erla;0_4;141;78;63;2021
AT1;AT12;AT121;30529;St. Pantaleon-Erla;5_9;130;68;62;2021
AT1;AT12;AT121;30529;St. Pantaleon-Erla;10_14;106;55;51;2021
AT1;AT12;AT121;30529;St. Pantaleon-Erla;15_19;151;85;66;2021
AT1;AT12;AT121;30529;St. Pantaleon-Erla;20_24;144;71;73;2021
AT1;AT12;AT121;30529;St. Pantaleon-Erla;25_29;154;87;67;2021
AT1;AT12;AT121;30529;St. Pantaleon-Erla;30_34;164;75;89;2021
AT1;AT12;AT121;30529;St. Pantaleon-Erla;35_39;193;109;84;2021
AT1;AT12;AT121;30529;St. Pantaleon-Erla;40_44;177;102;75;2021
AT1;AT12;AT121;30529;St. Pantaleon-Erla;45_49;191;88;103;2021
AT1;AT12;AT121;30529;St. Pantaleon-Erla;50_54;213;97;116;2021
AT1;AT12;AT121;30529;St. Pantaleon-Erla;55_59;243;126;117;2021
AT1;AT12;AT121;30529;St. Pantaleon-Erla;60_64;231;116;115;2021
AT1;AT12;AT121;30529;St. Pantaleon-Erla;65_69;136;72;64;2021
AT1;AT12;AT121;30529;St. Pantaleon-Erla;70_74;108;53;55;2021
AT1;AT12;AT121;30529;St. Pantaleon-Erla;75_79;67;31;36;2021
AT1;AT12;AT121;30529;St. Pantaleon-Erla;80_84;70;27;43;2021
AT1;AT12;AT121;30529;St. Pantaleon-Erla;85_89;35;15;20;2021
AT1;AT12;AT121;30529;St. Pantaleon-Erla;90_94;10;4;6;2021
AT1;AT12;AT121;30529;St. Pantaleon-Erla;95_;4;1;3;2021
AT1;AT12;AT121;30530;St. Peter in der Au;0_4;279;143;136;2021
AT1;AT12;AT121;30530;St. Peter in der Au;5_9;324;170;154;2021
AT1;AT12;AT121;30530;St. Peter in der Au;10_14;286;143;143;2021
AT1;AT12;AT121;30530;St. Peter in der Au;15_19;280;153;127;2021
AT1;AT12;AT121;30530;St. Peter in der Au;20_24;265;140;125;2021
AT1;AT12;AT121;30530;St. Peter in der Au;25_29;312;162;150;2021
AT1;AT12;AT121;30530;St. Peter in der Au;30_34;350;167;183;2021
AT1;AT12;AT121;30530;St. Peter in der Au;35_39;318;159;159;2021
AT1;AT12;AT121;30530;St. Peter in der Au;40_44;310;162;148;2021
AT1;AT12;AT121;30530;St. Peter in der Au;45_49;350;178;172;2021
AT1;AT12;AT121;30530;St. Peter in der Au;50_54;396;195;201;2021
AT1;AT12;AT121;30530;St. Peter in der Au;55_59;398;219;179;2021
AT1;AT12;AT121;30530;St. Peter in der Au;60_64;335;172;163;2021
AT1;AT12;AT121;30530;St. Peter in der Au;65_69;240;112;128;2021
AT1;AT12;AT121;30530;St. Peter in der Au;70_74;198;97;101;2021
AT1;AT12;AT121;30530;St. Peter in der Au;75_79;179;66;113;2021
AT1;AT12;AT121;30530;St. Peter in der Au;80_84;186;77;109;2021
AT1;AT12;AT121;30530;St. Peter in der Au;85_89;101;23;78;2021
AT1;AT12;AT121;30530;St. Peter in der Au;90_94;40;12;28;2021
AT1;AT12;AT121;30530;St. Peter in der Au;95_;14;3;11;2021
AT1;AT12;AT121;30531;St. Valentin;0_4;409;218;191;2021
AT1;AT12;AT121;30531;St. Valentin;5_9;379;228;151;2021
AT1;AT12;AT121;30531;St. Valentin;10_14;435;221;214;2021
AT1;AT12;AT121;30531;St. Valentin;15_19;408;197;211;2021
AT1;AT12;AT121;30531;St. Valentin;20_24;512;268;244;2021
AT1;AT12;AT121;30531;St. Valentin;25_29;597;303;294;2021
AT1;AT12;AT121;30531;St. Valentin;30_34;608;321;287;2021
AT1;AT12;AT121;30531;St. Valentin;35_39;591;317;274;2021
AT1;AT12;AT121;30531;St. Valentin;40_44;603;296;307;2021
AT1;AT12;AT121;30531;St. Valentin;45_49;631;314;317;2021
AT1;AT12;AT121;30531;St. Valentin;50_54;758;397;361;2021
AT1;AT12;AT121;30531;St. Valentin;55_59;807;412;395;2021
AT1;AT12;AT121;30531;St. Valentin;60_64;661;327;334;2021
AT1;AT12;AT121;30531;St. Valentin;65_69;525;249;276;2021
AT1;AT12;AT121;30531;St. Valentin;70_74;454;217;237;2021
AT1;AT12;AT121;30531;St. Valentin;75_79;389;167;222;2021
AT1;AT12;AT121;30531;St. Valentin;80_84;311;143;168;2021
AT1;AT12;AT121;30531;St. Valentin;85_89;174;71;103;2021
AT1;AT12;AT121;30531;St. Valentin;90_94;50;14;36;2021
AT1;AT12;AT121;30531;St. Valentin;95_;18;7;11;2021
AT1;AT12;AT121;30532;Seitenstetten;0_4;185;86;99;2021
AT1;AT12;AT121;30532;Seitenstetten;5_9;229;116;113;2021
AT1;AT12;AT121;30532;Seitenstetten;10_14;195;100;95;2021
AT1;AT12;AT121;30532;Seitenstetten;15_19;196;114;82;2021
AT1;AT12;AT121;30532;Seitenstetten;20_24;212;113;99;2021
AT1;AT12;AT121;30532;Seitenstetten;25_29;187;96;91;2021
AT1;AT12;AT121;30532;Seitenstetten;30_34;184;86;98;2021
AT1;AT12;AT121;30532;Seitenstetten;35_39;280;137;143;2021
AT1;AT12;AT121;30532;Seitenstetten;40_44;201;108;93;2021
AT1;AT12;AT121;30532;Seitenstetten;45_49;252;131;121;2021
AT1;AT12;AT121;30532;Seitenstetten;50_54;264;130;134;2021
AT1;AT12;AT121;30532;Seitenstetten;55_59;252;129;123;2021
AT1;AT12;AT121;30532;Seitenstetten;60_64;220;110;110;2021
AT1;AT12;AT121;30532;Seitenstetten;65_69;160;72;88;2021
AT1;AT12;AT121;30532;Seitenstetten;70_74;149;79;70;2021
AT1;AT12;AT121;30532;Seitenstetten;75_79;97;43;54;2021
AT1;AT12;AT121;30532;Seitenstetten;80_84;104;48;56;2021
AT1;AT12;AT121;30532;Seitenstetten;85_89;47;18;29;2021
AT1;AT12;AT121;30532;Seitenstetten;90_94;16;6;10;2021
AT1;AT12;AT121;30532;Seitenstetten;95_;1;0;1;2021
AT1;AT12;AT121;30533;Sonntagberg;0_4;196;107;89;2021
AT1;AT12;AT121;30533;Sonntagberg;5_9;179;94;85;2021
AT1;AT12;AT121;30533;Sonntagberg;10_14;166;75;91;2021
AT1;AT12;AT121;30533;Sonntagberg;15_19;184;96;88;2021
AT1;AT12;AT121;30533;Sonntagberg;20_24;207;115;92;2021
AT1;AT12;AT121;30533;Sonntagberg;25_29;234;120;114;2021
AT1;AT12;AT121;30533;Sonntagberg;30_34;232;118;114;2021
AT1;AT12;AT121;30533;Sonntagberg;35_39;245;130;115;2021
AT1;AT12;AT121;30533;Sonntagberg;40_44;192;101;91;2021
AT1;AT12;AT121;30533;Sonntagberg;45_49;201;100;101;2021
AT1;AT12;AT121;30533;Sonntagberg;50_54;301;154;147;2021
AT1;AT12;AT121;30533;Sonntagberg;55_59;312;160;152;2021
AT1;AT12;AT121;30533;Sonntagberg;60_64;251;124;127;2021
AT1;AT12;AT121;30533;Sonntagberg;65_69;207;101;106;2021
AT1;AT12;AT121;30533;Sonntagberg;70_74;188;81;107;2021
AT1;AT12;AT121;30533;Sonntagberg;75_79;172;71;101;2021
AT1;AT12;AT121;30533;Sonntagberg;80_84;161;71;90;2021
AT1;AT12;AT121;30533;Sonntagberg;85_89;98;40;58;2021
AT1;AT12;AT121;30533;Sonntagberg;90_94;28;10;18;2021
AT1;AT12;AT121;30533;Sonntagberg;95_;9;2;7;2021
AT1;AT12;AT121;30534;Strengberg;0_4;119;61;58;2021
AT1;AT12;AT121;30534;Strengberg;5_9;144;64;80;2021
AT1;AT12;AT121;30534;Strengberg;10_14;127;68;59;2021
AT1;AT12;AT121;30534;Strengberg;15_19;93;50;43;2021
AT1;AT12;AT121;30534;Strengberg;20_24;108;56;52;2021
AT1;AT12;AT121;30534;Strengberg;25_29;111;54;57;2021
AT1;AT12;AT121;30534;Strengberg;30_34;112;54;58;2021
AT1;AT12;AT121;30534;Strengberg;35_39;173;87;86;2021
AT1;AT12;AT121;30534;Strengberg;40_44;139;78;61;2021
AT1;AT12;AT121;30534;Strengberg;45_49;141;69;72;2021
AT1;AT12;AT121;30534;Strengberg;50_54;148;70;78;2021
AT1;AT12;AT121;30534;Strengberg;55_59;161;84;77;2021
AT1;AT12;AT121;30534;Strengberg;60_64;159;89;70;2021
AT1;AT12;AT121;30534;Strengberg;65_69;115;59;56;2021
AT1;AT12;AT121;30534;Strengberg;70_74;75;30;45;2021
AT1;AT12;AT121;30534;Strengberg;75_79;64;28;36;2021
AT1;AT12;AT121;30534;Strengberg;80_84;70;32;38;2021
AT1;AT12;AT121;30534;Strengberg;85_89;40;19;21;2021
AT1;AT12;AT121;30534;Strengberg;90_94;14;6;8;2021
AT1;AT12;AT121;30534;Strengberg;95_;4;0;4;2021
AT1;AT12;AT121;30536;Viehdorf;0_4;66;34;32;2021
AT1;AT12;AT121;30536;Viehdorf;5_9;94;52;42;2021
AT1;AT12;AT121;30536;Viehdorf;10_14;83;46;37;2021
AT1;AT12;AT121;30536;Viehdorf;15_19;60;28;32;2021
AT1;AT12;AT121;30536;Viehdorf;20_24;61;36;25;2021
AT1;AT12;AT121;30536;Viehdorf;25_29;79;44;35;2021
AT1;AT12;AT121;30536;Viehdorf;30_34;72;43;29;2021
AT1;AT12;AT121;30536;Viehdorf;35_39;107;44;63;2021
AT1;AT12;AT121;30536;Viehdorf;40_44;88;51;37;2021
AT1;AT12;AT121;30536;Viehdorf;45_49;86;46;40;2021
AT1;AT12;AT121;30536;Viehdorf;50_54;92;48;44;2021
AT1;AT12;AT121;30536;Viehdorf;55_59;101;46;55;2021
AT1;AT12;AT121;30536;Viehdorf;60_64;95;50;45;2021
AT1;AT12;AT121;30536;Viehdorf;65_69;70;33;37;2021
AT1;AT12;AT121;30536;Viehdorf;70_74;68;32;36;2021
AT1;AT12;AT121;30536;Viehdorf;75_79;38;18;20;2021
AT1;AT12;AT121;30536;Viehdorf;80_84;49;21;28;2021
AT1;AT12;AT121;30536;Viehdorf;85_89;31;13;18;2021
AT1;AT12;AT121;30536;Viehdorf;90_94;16;3;13;2021
AT1;AT12;AT121;30536;Viehdorf;95_;5;1;4;2021
AT1;AT12;AT121;30538;Wallsee-Sindelburg;0_4;125;65;60;2021
AT1;AT12;AT121;30538;Wallsee-Sindelburg;5_9;128;65;63;2021
AT1;AT12;AT121;30538;Wallsee-Sindelburg;10_14;112;50;62;2021
AT1;AT12;AT121;30538;Wallsee-Sindelburg;15_19;113;54;59;2021
AT1;AT12;AT121;30538;Wallsee-Sindelburg;20_24;125;77;48;2021
AT1;AT12;AT121;30538;Wallsee-Sindelburg;25_29;97;53;44;2021
AT1;AT12;AT121;30538;Wallsee-Sindelburg;30_34;152;73;79;2021
AT1;AT12;AT121;30538;Wallsee-Sindelburg;35_39;140;71;69;2021
AT1;AT12;AT121;30538;Wallsee-Sindelburg;40_44;151;76;75;2021
AT1;AT12;AT121;30538;Wallsee-Sindelburg;45_49;115;65;50;2021
AT1;AT12;AT121;30538;Wallsee-Sindelburg;50_54;160;79;81;2021
AT1;AT12;AT121;30538;Wallsee-Sindelburg;55_59;174;91;83;2021
AT1;AT12;AT121;30538;Wallsee-Sindelburg;60_64;148;78;70;2021
AT1;AT12;AT121;30538;Wallsee-Sindelburg;65_69;128;62;66;2021
AT1;AT12;AT121;30538;Wallsee-Sindelburg;70_74;63;28;35;2021
AT1;AT12;AT121;30538;Wallsee-Sindelburg;75_79;73;33;40;2021
AT1;AT12;AT121;30538;Wallsee-Sindelburg;80_84;90;33;57;2021
AT1;AT12;AT121;30538;Wallsee-Sindelburg;85_89;53;14;39;2021
AT1;AT12;AT121;30538;Wallsee-Sindelburg;90_94;39;8;31;2021
AT1;AT12;AT121;30538;Wallsee-Sindelburg;95_;8;2;6;2021
AT1;AT12;AT121;30539;Weistrach;0_4;118;60;58;2021
AT1;AT12;AT121;30539;Weistrach;5_9;127;59;68;2021
AT1;AT12;AT121;30539;Weistrach;10_14;117;62;55;2021
AT1;AT12;AT121;30539;Weistrach;15_19;123;53;70;2021
AT1;AT12;AT121;30539;Weistrach;20_24;135;68;67;2021
AT1;AT12;AT121;30539;Weistrach;25_29;163;78;85;2021
AT1;AT12;AT121;30539;Weistrach;30_34;158;85;73;2021
AT1;AT12;AT121;30539;Weistrach;35_39;139;72;67;2021
AT1;AT12;AT121;30539;Weistrach;40_44;135;68;67;2021
AT1;AT12;AT121;30539;Weistrach;45_49;167;85;82;2021
AT1;AT12;AT121;30539;Weistrach;50_54;177;95;82;2021
AT1;AT12;AT121;30539;Weistrach;55_59;153;76;77;2021
AT1;AT12;AT121;30539;Weistrach;60_64;162;89;73;2021
AT1;AT12;AT121;30539;Weistrach;65_69;128;61;67;2021
AT1;AT12;AT121;30539;Weistrach;70_74;80;35;45;2021
AT1;AT12;AT121;30539;Weistrach;75_79;63;32;31;2021
AT1;AT12;AT121;30539;Weistrach;80_84;83;33;50;2021
AT1;AT12;AT121;30539;Weistrach;85_89;32;14;18;2021
AT1;AT12;AT121;30539;Weistrach;90_94;15;6;9;2021
AT1;AT12;AT121;30539;Weistrach;95_;3;0;3;2021
AT1;AT12;AT121;30541;Winklarn;0_4;114;62;52;2021
AT1;AT12;AT121;30541;Winklarn;5_9;106;56;50;2021
AT1;AT12;AT121;30541;Winklarn;10_14;92;52;40;2021
AT1;AT12;AT121;30541;Winklarn;15_19;89;50;39;2021
AT1;AT12;AT121;30541;Winklarn;20_24;88;46;42;2021
AT1;AT12;AT121;30541;Winklarn;25_29;111;57;54;2021
AT1;AT12;AT121;30541;Winklarn;30_34;126;54;72;2021
AT1;AT12;AT121;30541;Winklarn;35_39;148;81;67;2021
AT1;AT12;AT121;30541;Winklarn;40_44;121;65;56;2021
AT1;AT12;AT121;30541;Winklarn;45_49;123;61;62;2021
AT1;AT12;AT121;30541;Winklarn;50_54;154;73;81;2021
AT1;AT12;AT121;30541;Winklarn;55_59;167;84;83;2021
AT1;AT12;AT121;30541;Winklarn;60_64;120;61;59;2021
AT1;AT12;AT121;30541;Winklarn;65_69;89;47;42;2021
AT1;AT12;AT121;30541;Winklarn;70_74;56;24;32;2021
AT1;AT12;AT121;30541;Winklarn;75_79;53;23;30;2021
AT1;AT12;AT121;30541;Winklarn;80_84;48;24;24;2021
AT1;AT12;AT121;30541;Winklarn;85_89;29;11;18;2021
AT1;AT12;AT121;30541;Winklarn;90_94;8;3;5;2021
AT1;AT12;AT121;30541;Winklarn;95_;1;1;0;2021
AT1;AT12;AT121;30542;Wolfsbach;0_4;142;69;73;2021
AT1;AT12;AT121;30542;Wolfsbach;5_9;132;64;68;2021
AT1;AT12;AT121;30542;Wolfsbach;10_14;114;64;50;2021
AT1;AT12;AT121;30542;Wolfsbach;15_19;88;48;40;2021
AT1;AT12;AT121;30542;Wolfsbach;20_24;90;49;41;2021
AT1;AT12;AT121;30542;Wolfsbach;25_29;123;72;51;2021
AT1;AT12;AT121;30542;Wolfsbach;30_34;153;81;72;2021
AT1;AT12;AT121;30542;Wolfsbach;35_39;172;85;87;2021
AT1;AT12;AT121;30542;Wolfsbach;40_44;141;71;70;2021
AT1;AT12;AT121;30542;Wolfsbach;45_49;122;70;52;2021
AT1;AT12;AT121;30542;Wolfsbach;50_54;136;70;66;2021
AT1;AT12;AT121;30542;Wolfsbach;55_59;172;92;80;2021
AT1;AT12;AT121;30542;Wolfsbach;60_64;141;78;63;2021
AT1;AT12;AT121;30542;Wolfsbach;65_69;109;57;52;2021
AT1;AT12;AT121;30542;Wolfsbach;70_74;62;26;36;2021
AT1;AT12;AT121;30542;Wolfsbach;75_79;47;18;29;2021
AT1;AT12;AT121;30542;Wolfsbach;80_84;62;31;31;2021
AT1;AT12;AT121;30542;Wolfsbach;85_89;42;16;26;2021
AT1;AT12;AT121;30542;Wolfsbach;90_94;11;2;9;2021
AT1;AT12;AT121;30542;Wolfsbach;95_;3;1;2;2021
AT1;AT12;AT121;30543;Ybbsitz;0_4;176;87;89;2021
AT1;AT12;AT121;30543;Ybbsitz;5_9;173;89;84;2021
AT1;AT12;AT121;30543;Ybbsitz;10_14;174;93;81;2021
AT1;AT12;AT121;30543;Ybbsitz;15_19;173;95;78;2021
AT1;AT12;AT121;30543;Ybbsitz;20_24;220;119;101;2021
AT1;AT12;AT121;30543;Ybbsitz;25_29;202;102;100;2021
AT1;AT12;AT121;30543;Ybbsitz;30_34;163;94;69;2021
AT1;AT12;AT121;30543;Ybbsitz;35_39;214;113;101;2021
AT1;AT12;AT121;30543;Ybbsitz;40_44;173;92;81;2021
AT1;AT12;AT121;30543;Ybbsitz;45_49;217;119;98;2021
AT1;AT12;AT121;30543;Ybbsitz;50_54;263;132;131;2021
AT1;AT12;AT121;30543;Ybbsitz;55_59;288;161;127;2021
AT1;AT12;AT121;30543;Ybbsitz;60_64;223;104;119;2021
AT1;AT12;AT121;30543;Ybbsitz;65_69;218;120;98;2021
AT1;AT12;AT121;30543;Ybbsitz;70_74;136;70;66;2021
AT1;AT12;AT121;30543;Ybbsitz;75_79;122;52;70;2021
AT1;AT12;AT121;30543;Ybbsitz;80_84;123;51;72;2021
AT1;AT12;AT121;30543;Ybbsitz;85_89;76;28;48;2021
AT1;AT12;AT121;30543;Ybbsitz;90_94;38;17;21;2021
AT1;AT12;AT121;30543;Ybbsitz;95_;6;3;3;2021
AT1;AT12;AT121;30544;Zeillern;0_4;107;53;54;2021
AT1;AT12;AT121;30544;Zeillern;5_9;112;53;59;2021
AT1;AT12;AT121;30544;Zeillern;10_14;111;68;43;2021
AT1;AT12;AT121;30544;Zeillern;15_19;101;57;44;2021
AT1;AT12;AT121;30544;Zeillern;20_24;105;52;53;2021
AT1;AT12;AT121;30544;Zeillern;25_29;112;63;49;2021
AT1;AT12;AT121;30544;Zeillern;30_34;115;60;55;2021
AT1;AT12;AT121;30544;Zeillern;35_39;133;59;74;2021
AT1;AT12;AT121;30544;Zeillern;40_44;132;73;59;2021
AT1;AT12;AT121;30544;Zeillern;45_49;119;68;51;2021
AT1;AT12;AT121;30544;Zeillern;50_54;165;84;81;2021
AT1;AT12;AT121;30544;Zeillern;55_59;143;76;67;2021
AT1;AT12;AT121;30544;Zeillern;60_64;111;60;51;2021
AT1;AT12;AT121;30544;Zeillern;65_69;89;41;48;2021
AT1;AT12;AT121;30544;Zeillern;70_74;70;36;34;2021
AT1;AT12;AT121;30544;Zeillern;75_79;43;21;22;2021
AT1;AT12;AT121;30544;Zeillern;80_84;55;22;33;2021
AT1;AT12;AT121;30544;Zeillern;85_89;37;18;19;2021
AT1;AT12;AT121;30544;Zeillern;90_94;15;6;9;2021
AT1;AT12;AT121;30544;Zeillern;95_;1;0;1;2021
AT1;AT12;AT127;30601;Alland;0_4;107;53;54;2021
AT1;AT12;AT127;30601;Alland;5_9;110;58;52;2021
AT1;AT12;AT127;30601;Alland;10_14;109;55;54;2021
AT1;AT12;AT127;30601;Alland;15_19;124;69;55;2021
AT1;AT12;AT127;30601;Alland;20_24;120;63;57;2021
AT1;AT12;AT127;30601;Alland;25_29;147;79;68;2021
AT1;AT12;AT127;30601;Alland;30_34;140;70;70;2021
AT1;AT12;AT127;30601;Alland;35_39;170;89;81;2021
AT1;AT12;AT127;30601;Alland;40_44;162;80;82;2021
AT1;AT12;AT127;30601;Alland;45_49;207;106;101;2021
AT1;AT12;AT127;30601;Alland;50_54;232;109;123;2021
AT1;AT12;AT127;30601;Alland;55_59;263;131;132;2021
AT1;AT12;AT127;30601;Alland;60_64;199;105;94;2021
AT1;AT12;AT127;30601;Alland;65_69;129;64;65;2021
AT1;AT12;AT127;30601;Alland;70_74;111;51;60;2021
AT1;AT12;AT127;30601;Alland;75_79;93;48;45;2021
AT1;AT12;AT127;30601;Alland;80_84;89;36;53;2021
AT1;AT12;AT127;30601;Alland;85_89;56;19;37;2021
AT1;AT12;AT127;30601;Alland;90_94;30;8;22;2021
AT1;AT12;AT127;30601;Alland;95_;8;2;6;2021
AT1;AT12;AT122;30602;Altenmarkt an der Triesting;0_4;96;57;39;2021
AT1;AT12;AT122;30602;Altenmarkt an der Triesting;5_9;116;46;70;2021
AT1;AT12;AT122;30602;Altenmarkt an der Triesting;10_14;117;57;60;2021
AT1;AT12;AT122;30602;Altenmarkt an der Triesting;15_19;94;51;43;2021
AT1;AT12;AT122;30602;Altenmarkt an der Triesting;20_24;73;35;38;2021
AT1;AT12;AT122;30602;Altenmarkt an der Triesting;25_29;95;53;42;2021
AT1;AT12;AT122;30602;Altenmarkt an der Triesting;30_34;125;59;66;2021
AT1;AT12;AT122;30602;Altenmarkt an der Triesting;35_39;143;72;71;2021
AT1;AT12;AT122;30602;Altenmarkt an der Triesting;40_44;137;73;64;2021
AT1;AT12;AT122;30602;Altenmarkt an der Triesting;45_49;146;70;76;2021
AT1;AT12;AT122;30602;Altenmarkt an der Triesting;50_54;187;91;96;2021
AT1;AT12;AT122;30602;Altenmarkt an der Triesting;55_59;169;89;80;2021
AT1;AT12;AT122;30602;Altenmarkt an der Triesting;60_64;133;67;66;2021
AT1;AT12;AT122;30602;Altenmarkt an der Triesting;65_69;131;77;54;2021
AT1;AT12;AT122;30602;Altenmarkt an der Triesting;70_74;86;36;50;2021
AT1;AT12;AT122;30602;Altenmarkt an der Triesting;75_79;80;41;39;2021
AT1;AT12;AT122;30602;Altenmarkt an der Triesting;80_84;71;33;38;2021
AT1;AT12;AT122;30602;Altenmarkt an der Triesting;85_89;41;14;27;2021
AT1;AT12;AT122;30602;Altenmarkt an der Triesting;90_94;24;3;21;2021
AT1;AT12;AT122;30602;Altenmarkt an der Triesting;95_;3;0;3;2021
AT1;AT12;AT127;30603;Bad V�slau;0_4;552;274;278;2021
AT1;AT12;AT127;30603;Bad V�slau;5_9;594;291;303;2021
AT1;AT12;AT127;30603;Bad V�slau;10_14;564;285;279;2021
AT1;AT12;AT127;30603;Bad V�slau;15_19;595;306;289;2021
AT1;AT12;AT127;30603;Bad V�slau;20_24;637;328;309;2021
AT1;AT12;AT127;30603;Bad V�slau;25_29;751;400;351;2021
AT1;AT12;AT127;30603;Bad V�slau;30_34;734;397;337;2021
AT1;AT12;AT127;30603;Bad V�slau;35_39;762;369;393;2021
AT1;AT12;AT127;30603;Bad V�slau;40_44;762;373;389;2021
AT1;AT12;AT127;30603;Bad V�slau;45_49;831;390;441;2021
AT1;AT12;AT127;30603;Bad V�slau;50_54;1006;497;509;2021
AT1;AT12;AT127;30603;Bad V�slau;55_59;994;500;494;2021
AT1;AT12;AT127;30603;Bad V�slau;60_64;822;418;404;2021
AT1;AT12;AT127;30603;Bad V�slau;65_69;674;301;373;2021
AT1;AT12;AT127;30603;Bad V�slau;70_74;635;275;360;2021
AT1;AT12;AT127;30603;Bad V�slau;75_79;574;241;333;2021
AT1;AT12;AT127;30603;Bad V�slau;80_84;419;182;237;2021
AT1;AT12;AT127;30603;Bad V�slau;85_89;238;73;165;2021
AT1;AT12;AT127;30603;Bad V�slau;90_94;126;35;91;2021
AT1;AT12;AT127;30603;Bad V�slau;95_;42;7;35;2021
AT1;AT12;AT127;30604;Baden;0_4;1041;535;506;2021
AT1;AT12;AT127;30604;Baden;5_9;1085;535;550;2021
AT1;AT12;AT127;30604;Baden;10_14;1133;585;548;2021
AT1;AT12;AT127;30604;Baden;15_19;1264;631;633;2021
AT1;AT12;AT127;30604;Baden;20_24;1224;623;601;2021
AT1;AT12;AT127;30604;Baden;25_29;1281;657;624;2021
AT1;AT12;AT127;30604;Baden;30_34;1426;747;679;2021
AT1;AT12;AT127;30604;Baden;35_39;1493;708;785;2021
AT1;AT12;AT127;30604;Baden;40_44;1571;721;850;2021
AT1;AT12;AT127;30604;Baden;45_49;1813;880;933;2021
AT1;AT12;AT127;30604;Baden;50_54;2098;987;1111;2021
AT1;AT12;AT127;30604;Baden;55_59;2046;974;1072;2021
AT1;AT12;AT127;30604;Baden;60_64;1779;843;936;2021
AT1;AT12;AT127;30604;Baden;65_69;1411;578;833;2021
AT1;AT12;AT127;30604;Baden;70_74;1501;650;851;2021
AT1;AT12;AT127;30604;Baden;75_79;1570;655;915;2021
AT1;AT12;AT127;30604;Baden;80_84;1203;510;693;2021
AT1;AT12;AT127;30604;Baden;85_89;532;207;325;2021
AT1;AT12;AT127;30604;Baden;90_94;261;72;189;2021
AT1;AT12;AT127;30604;Baden;95_;85;19;66;2021
AT1;AT12;AT122;30605;Berndorf;0_4;392;195;197;2021
AT1;AT12;AT122;30605;Berndorf;5_9;442;232;210;2021
AT1;AT12;AT122;30605;Berndorf;10_14;455;241;214;2021
AT1;AT12;AT122;30605;Berndorf;15_19;472;252;220;2021
AT1;AT12;AT122;30605;Berndorf;20_24;461;226;235;2021
AT1;AT12;AT122;30605;Berndorf;25_29;532;267;265;2021
AT1;AT12;AT122;30605;Berndorf;30_34;538;282;256;2021
AT1;AT12;AT122;30605;Berndorf;35_39;598;295;303;2021
AT1;AT12;AT122;30605;Berndorf;40_44;557;281;276;2021
AT1;AT12;AT122;30605;Berndorf;45_49;646;310;336;2021
AT1;AT12;AT122;30605;Berndorf;50_54;716;355;361;2021
AT1;AT12;AT122;30605;Berndorf;55_59;702;359;343;2021
AT1;AT12;AT122;30605;Berndorf;60_64;629;292;337;2021
AT1;AT12;AT122;30605;Berndorf;65_69;508;246;262;2021
AT1;AT12;AT122;30605;Berndorf;70_74;509;241;268;2021
AT1;AT12;AT122;30605;Berndorf;75_79;402;189;213;2021
AT1;AT12;AT122;30605;Berndorf;80_84;287;128;159;2021
AT1;AT12;AT122;30605;Berndorf;85_89;137;47;90;2021
AT1;AT12;AT122;30605;Berndorf;90_94;75;20;55;2021
AT1;AT12;AT122;30605;Berndorf;95_;18;4;14;2021
AT1;AT12;AT127;30607;Ebreichsdorf;0_4;645;327;318;2021
AT1;AT12;AT127;30607;Ebreichsdorf;5_9;638;305;333;2021
AT1;AT12;AT127;30607;Ebreichsdorf;10_14;598;311;287;2021
AT1;AT12;AT127;30607;Ebreichsdorf;15_19;559;294;265;2021
AT1;AT12;AT127;30607;Ebreichsdorf;20_24;485;253;232;2021
AT1;AT12;AT127;30607;Ebreichsdorf;25_29;639;321;318;2021
AT1;AT12;AT127;30607;Ebreichsdorf;30_34;776;381;395;2021
AT1;AT12;AT127;30607;Ebreichsdorf;35_39;872;417;455;2021
AT1;AT12;AT127;30607;Ebreichsdorf;40_44;818;434;384;2021
AT1;AT12;AT127;30607;Ebreichsdorf;45_49;800;405;395;2021
AT1;AT12;AT127;30607;Ebreichsdorf;50_54;976;479;497;2021
AT1;AT12;AT127;30607;Ebreichsdorf;55_59;950;450;500;2021
AT1;AT12;AT127;30607;Ebreichsdorf;60_64;741;374;367;2021
AT1;AT12;AT127;30607;Ebreichsdorf;65_69;554;264;290;2021
AT1;AT12;AT127;30607;Ebreichsdorf;70_74;514;241;273;2021
AT1;AT12;AT127;30607;Ebreichsdorf;75_79;399;181;218;2021
AT1;AT12;AT127;30607;Ebreichsdorf;80_84;271;110;161;2021
AT1;AT12;AT127;30607;Ebreichsdorf;85_89;141;54;87;2021
AT1;AT12;AT127;30607;Ebreichsdorf;90_94;34;14;20;2021
AT1;AT12;AT127;30607;Ebreichsdorf;95_;12;1;11;2021
AT1;AT12;AT122;30608;Enzesfeld-Lindabrunn;0_4;188;97;91;2021
AT1;AT12;AT122;30608;Enzesfeld-Lindabrunn;5_9;205;101;104;2021
AT1;AT12;AT122;30608;Enzesfeld-Lindabrunn;10_14;190;94;96;2021
AT1;AT12;AT122;30608;Enzesfeld-Lindabrunn;15_19;226;114;112;2021
AT1;AT12;AT122;30608;Enzesfeld-Lindabrunn;20_24;223;123;100;2021
AT1;AT12;AT122;30608;Enzesfeld-Lindabrunn;25_29;193;82;111;2021
AT1;AT12;AT122;30608;Enzesfeld-Lindabrunn;30_34;227;122;105;2021
AT1;AT12;AT122;30608;Enzesfeld-Lindabrunn;35_39;242;119;123;2021
AT1;AT12;AT122;30608;Enzesfeld-Lindabrunn;40_44;264;128;136;2021
AT1;AT12;AT122;30608;Enzesfeld-Lindabrunn;45_49;304;137;167;2021
AT1;AT12;AT122;30608;Enzesfeld-Lindabrunn;50_54;386;196;190;2021
AT1;AT12;AT122;30608;Enzesfeld-Lindabrunn;55_59;380;186;194;2021
AT1;AT12;AT122;30608;Enzesfeld-Lindabrunn;60_64;310;167;143;2021
AT1;AT12;AT122;30608;Enzesfeld-Lindabrunn;65_69;200;94;106;2021
AT1;AT12;AT122;30608;Enzesfeld-Lindabrunn;70_74;236;107;129;2021
AT1;AT12;AT122;30608;Enzesfeld-Lindabrunn;75_79;221;95;126;2021
AT1;AT12;AT122;30608;Enzesfeld-Lindabrunn;80_84;159;71;88;2021
AT1;AT12;AT122;30608;Enzesfeld-Lindabrunn;85_89;42;14;28;2021
AT1;AT12;AT122;30608;Enzesfeld-Lindabrunn;90_94;24;7;17;2021
AT1;AT12;AT122;30608;Enzesfeld-Lindabrunn;95_;7;0;7;2021
AT1;AT12;AT122;30609;Furth an der Triesting;0_4;43;19;24;2021
AT1;AT12;AT122;30609;Furth an der Triesting;5_9;52;31;21;2021
AT1;AT12;AT122;30609;Furth an der Triesting;10_14;54;24;30;2021
AT1;AT12;AT122;30609;Furth an der Triesting;15_19;49;32;17;2021
AT1;AT12;AT122;30609;Furth an der Triesting;20_24;33;11;22;2021
AT1;AT12;AT122;30609;Furth an der Triesting;25_29;36;20;16;2021
AT1;AT12;AT122;30609;Furth an der Triesting;30_34;52;25;27;2021
AT1;AT12;AT122;30609;Furth an der Triesting;35_39;70;38;32;2021
AT1;AT12;AT122;30609;Furth an der Triesting;40_44;50;24;26;2021
AT1;AT12;AT122;30609;Furth an der Triesting;45_49;63;35;28;2021
AT1;AT12;AT122;30609;Furth an der Triesting;50_54;68;33;35;2021
AT1;AT12;AT122;30609;Furth an der Triesting;55_59;68;33;35;2021
AT1;AT12;AT122;30609;Furth an der Triesting;60_64;69;39;30;2021
AT1;AT12;AT122;30609;Furth an der Triesting;65_69;45;16;29;2021
AT1;AT12;AT122;30609;Furth an der Triesting;70_74;35;19;16;2021
AT1;AT12;AT122;30609;Furth an der Triesting;75_79;32;10;22;2021
AT1;AT12;AT122;30609;Furth an der Triesting;80_84;29;19;10;2021
AT1;AT12;AT122;30609;Furth an der Triesting;85_89;10;3;7;2021
AT1;AT12;AT122;30609;Furth an der Triesting;90_94;6;3;3;2021
AT1;AT12;AT122;30609;Furth an der Triesting;95_;1;1;0;2021
AT1;AT12;AT127;30612;G�nselsdorf;0_4;64;29;35;2021
AT1;AT12;AT127;30612;G�nselsdorf;5_9;65;40;25;2021
AT1;AT12;AT127;30612;G�nselsdorf;10_14;77;39;38;2021
AT1;AT12;AT127;30612;G�nselsdorf;15_19;72;32;40;2021
AT1;AT12;AT127;30612;G�nselsdorf;20_24;83;38;45;2021
AT1;AT12;AT127;30612;G�nselsdorf;25_29;102;54;48;2021
AT1;AT12;AT127;30612;G�nselsdorf;30_34;116;59;57;2021
AT1;AT12;AT127;30612;G�nselsdorf;35_39;123;61;62;2021
AT1;AT12;AT127;30612;G�nselsdorf;40_44;95;43;52;2021
AT1;AT12;AT127;30612;G�nselsdorf;45_49;126;49;77;2021
AT1;AT12;AT127;30612;G�nselsdorf;50_54;156;82;74;2021
AT1;AT12;AT127;30612;G�nselsdorf;55_59;146;77;69;2021
AT1;AT12;AT127;30612;G�nselsdorf;60_64;134;71;63;2021
AT1;AT12;AT127;30612;G�nselsdorf;65_69;103;41;62;2021
AT1;AT12;AT127;30612;G�nselsdorf;70_74;89;37;52;2021
AT1;AT12;AT127;30612;G�nselsdorf;75_79;73;30;43;2021
AT1;AT12;AT127;30612;G�nselsdorf;80_84;40;13;27;2021
AT1;AT12;AT127;30612;G�nselsdorf;85_89;23;10;13;2021
AT1;AT12;AT127;30612;G�nselsdorf;90_94;9;4;5;2021
AT1;AT12;AT127;30612;G�nselsdorf;95_;1;0;1;2021
AT1;AT12;AT127;30613;Heiligenkreuz;0_4;63;33;30;2021
AT1;AT12;AT127;30613;Heiligenkreuz;5_9;73;37;36;2021
AT1;AT12;AT127;30613;Heiligenkreuz;10_14;83;40;43;2021
AT1;AT12;AT127;30613;Heiligenkreuz;15_19;80;39;41;2021
AT1;AT12;AT127;30613;Heiligenkreuz;20_24;58;34;24;2021
AT1;AT12;AT127;30613;Heiligenkreuz;25_29;75;36;39;2021
AT1;AT12;AT127;30613;Heiligenkreuz;30_34;90;48;42;2021
AT1;AT12;AT127;30613;Heiligenkreuz;35_39;87;48;39;2021
AT1;AT12;AT127;30613;Heiligenkreuz;40_44;103;56;47;2021
AT1;AT12;AT127;30613;Heiligenkreuz;45_49;128;70;58;2021
AT1;AT12;AT127;30613;Heiligenkreuz;50_54;124;69;55;2021
AT1;AT12;AT127;30613;Heiligenkreuz;55_59;129;67;62;2021
AT1;AT12;AT127;30613;Heiligenkreuz;60_64;110;58;52;2021
AT1;AT12;AT127;30613;Heiligenkreuz;65_69;81;38;43;2021
AT1;AT12;AT127;30613;Heiligenkreuz;70_74;84;44;40;2021
AT1;AT12;AT127;30613;Heiligenkreuz;75_79;78;36;42;2021
AT1;AT12;AT127;30613;Heiligenkreuz;80_84;50;31;19;2021
AT1;AT12;AT127;30613;Heiligenkreuz;85_89;24;10;14;2021
AT1;AT12;AT127;30613;Heiligenkreuz;90_94;9;3;6;2021
AT1;AT12;AT127;30613;Heiligenkreuz;95_;3;1;2;2021
AT1;AT12;AT122;30614;Hernstein;0_4;76;37;39;2021
AT1;AT12;AT122;30614;Hernstein;5_9;65;37;28;2021
AT1;AT12;AT122;30614;Hernstein;10_14;67;32;35;2021
AT1;AT12;AT122;30614;Hernstein;15_19;83;47;36;2021
AT1;AT12;AT122;30614;Hernstein;20_24;63;34;29;2021
AT1;AT12;AT122;30614;Hernstein;25_29;77;41;36;2021
AT1;AT12;AT122;30614;Hernstein;30_34;79;41;38;2021
AT1;AT12;AT122;30614;Hernstein;35_39;98;50;48;2021
AT1;AT12;AT122;30614;Hernstein;40_44;99;44;55;2021
AT1;AT12;AT122;30614;Hernstein;45_49;106;59;47;2021
AT1;AT12;AT122;30614;Hernstein;50_54;145;73;72;2021
AT1;AT12;AT122;30614;Hernstein;55_59;158;80;78;2021
AT1;AT12;AT122;30614;Hernstein;60_64;115;54;61;2021
AT1;AT12;AT122;30614;Hernstein;65_69;83;37;46;2021
AT1;AT12;AT122;30614;Hernstein;70_74;93;43;50;2021
AT1;AT12;AT122;30614;Hernstein;75_79;66;34;32;2021
AT1;AT12;AT122;30614;Hernstein;80_84;52;28;24;2021
AT1;AT12;AT122;30614;Hernstein;85_89;29;13;16;2021
AT1;AT12;AT122;30614;Hernstein;90_94;9;4;5;2021
AT1;AT12;AT122;30614;Hernstein;95_;4;1;3;2021
AT1;AT12;AT122;30615;Hirtenberg;0_4;88;57;31;2021
AT1;AT12;AT122;30615;Hirtenberg;5_9;103;40;63;2021
AT1;AT12;AT122;30615;Hirtenberg;10_14;113;56;57;2021
AT1;AT12;AT122;30615;Hirtenberg;15_19;132;54;78;2021
AT1;AT12;AT122;30615;Hirtenberg;20_24;175;113;62;2021
AT1;AT12;AT122;30615;Hirtenberg;25_29;179;117;62;2021
AT1;AT12;AT122;30615;Hirtenberg;30_34;214;149;65;2021
AT1;AT12;AT122;30615;Hirtenberg;35_39;203;129;74;2021
AT1;AT12;AT122;30615;Hirtenberg;40_44;166;110;56;2021
AT1;AT12;AT122;30615;Hirtenberg;45_49;206;110;96;2021
AT1;AT12;AT122;30615;Hirtenberg;50_54;201;116;85;2021
AT1;AT12;AT122;30615;Hirtenberg;55_59;208;113;95;2021
AT1;AT12;AT122;30615;Hirtenberg;60_64;128;66;62;2021
AT1;AT12;AT122;30615;Hirtenberg;65_69;108;45;63;2021
AT1;AT12;AT122;30615;Hirtenberg;70_74;105;47;58;2021
AT1;AT12;AT122;30615;Hirtenberg;75_79;100;44;56;2021
AT1;AT12;AT122;30615;Hirtenberg;80_84;83;43;40;2021
AT1;AT12;AT122;30615;Hirtenberg;85_89;37;13;24;2021
AT1;AT12;AT122;30615;Hirtenberg;90_94;15;2;13;2021
AT1;AT12;AT122;30615;Hirtenberg;95_;1;0;1;2021
AT1;AT12;AT127;30616;Klausen-Leopoldsdorf;0_4;82;40;42;2021
AT1;AT12;AT127;30616;Klausen-Leopoldsdorf;5_9;83;36;47;2021
AT1;AT12;AT127;30616;Klausen-Leopoldsdorf;10_14;81;37;44;2021
AT1;AT12;AT127;30616;Klausen-Leopoldsdorf;15_19;95;43;52;2021
AT1;AT12;AT127;30616;Klausen-Leopoldsdorf;20_24;79;31;48;2021
AT1;AT12;AT127;30616;Klausen-Leopoldsdorf;25_29;103;48;55;2021
AT1;AT12;AT127;30616;Klausen-Leopoldsdorf;30_34;116;60;56;2021
AT1;AT12;AT127;30616;Klausen-Leopoldsdorf;35_39;120;50;70;2021
AT1;AT12;AT127;30616;Klausen-Leopoldsdorf;40_44;115;59;56;2021
AT1;AT12;AT127;30616;Klausen-Leopoldsdorf;45_49;140;68;72;2021
AT1;AT12;AT127;30616;Klausen-Leopoldsdorf;50_54;160;87;73;2021
AT1;AT12;AT127;30616;Klausen-Leopoldsdorf;55_59;145;72;73;2021
AT1;AT12;AT127;30616;Klausen-Leopoldsdorf;60_64;89;50;39;2021
AT1;AT12;AT127;30616;Klausen-Leopoldsdorf;65_69;96;48;48;2021
AT1;AT12;AT127;30616;Klausen-Leopoldsdorf;70_74;78;35;43;2021
AT1;AT12;AT127;30616;Klausen-Leopoldsdorf;75_79;56;25;31;2021
AT1;AT12;AT127;30616;Klausen-Leopoldsdorf;80_84;32;15;17;2021
AT1;AT12;AT127;30616;Klausen-Leopoldsdorf;85_89;27;3;24;2021
AT1;AT12;AT127;30616;Klausen-Leopoldsdorf;90_94;9;4;5;2021
AT1;AT12;AT127;30616;Klausen-Leopoldsdorf;95_;1;0;1;2021
AT1;AT12;AT127;30618;Kottingbrunn;0_4;288;139;149;2021
AT1;AT12;AT127;30618;Kottingbrunn;5_9;320;153;167;2021
AT1;AT12;AT127;30618;Kottingbrunn;10_14;343;173;170;2021
AT1;AT12;AT127;30618;Kottingbrunn;15_19;378;193;185;2021
AT1;AT12;AT127;30618;Kottingbrunn;20_24;373;207;166;2021
AT1;AT12;AT127;30618;Kottingbrunn;25_29;347;180;167;2021
AT1;AT12;AT127;30618;Kottingbrunn;30_34;399;214;185;2021
AT1;AT12;AT127;30618;Kottingbrunn;35_39;467;213;254;2021
AT1;AT12;AT127;30618;Kottingbrunn;40_44;437;231;206;2021
AT1;AT12;AT127;30618;Kottingbrunn;45_49;512;240;272;2021
AT1;AT12;AT127;30618;Kottingbrunn;50_54;747;363;384;2021
AT1;AT12;AT127;30618;Kottingbrunn;55_59;684;331;353;2021
AT1;AT12;AT127;30618;Kottingbrunn;60_64;528;264;264;2021
AT1;AT12;AT127;30618;Kottingbrunn;65_69;374;182;192;2021
AT1;AT12;AT127;30618;Kottingbrunn;70_74;395;178;217;2021
AT1;AT12;AT127;30618;Kottingbrunn;75_79;348;157;191;2021
AT1;AT12;AT127;30618;Kottingbrunn;80_84;236;92;144;2021
AT1;AT12;AT127;30618;Kottingbrunn;85_89;82;25;57;2021
AT1;AT12;AT127;30618;Kottingbrunn;90_94;42;10;32;2021
AT1;AT12;AT127;30618;Kottingbrunn;95_;3;0;3;2021
AT1;AT12;AT127;30620;Leobersdorf;0_4;222;112;110;2021
AT1;AT12;AT127;30620;Leobersdorf;5_9;245;138;107;2021
AT1;AT12;AT127;30620;Leobersdorf;10_14;227;119;108;2021
AT1;AT12;AT127;30620;Leobersdorf;15_19;295;158;137;2021
AT1;AT12;AT127;30620;Leobersdorf;20_24;284;135;149;2021
AT1;AT12;AT127;30620;Leobersdorf;25_29;345;170;175;2021
AT1;AT12;AT127;30620;Leobersdorf;30_34;392;219;173;2021
AT1;AT12;AT127;30620;Leobersdorf;35_39;325;151;174;2021
AT1;AT12;AT127;30620;Leobersdorf;40_44;307;140;167;2021
AT1;AT12;AT127;30620;Leobersdorf;45_49;340;158;182;2021
AT1;AT12;AT127;30620;Leobersdorf;50_54;405;200;205;2021
AT1;AT12;AT127;30620;Leobersdorf;55_59;363;179;184;2021
AT1;AT12;AT127;30620;Leobersdorf;60_64;315;138;177;2021
AT1;AT12;AT127;30620;Leobersdorf;65_69;237;110;127;2021
AT1;AT12;AT127;30620;Leobersdorf;70_74;215;109;106;2021
AT1;AT12;AT127;30620;Leobersdorf;75_79;201;85;116;2021
AT1;AT12;AT127;30620;Leobersdorf;80_84;133;61;72;2021
AT1;AT12;AT127;30620;Leobersdorf;85_89;52;14;38;2021
AT1;AT12;AT127;30620;Leobersdorf;90_94;32;7;25;2021
AT1;AT12;AT127;30620;Leobersdorf;95_;11;4;7;2021
AT1;AT12;AT127;30621;Mitterndorf an der Fischa;0_4;184;87;97;2021
AT1;AT12;AT127;30621;Mitterndorf an der Fischa;5_9;203;99;104;2021
AT1;AT12;AT127;30621;Mitterndorf an der Fischa;10_14;179;104;75;2021
AT1;AT12;AT127;30621;Mitterndorf an der Fischa;15_19;162;84;78;2021
AT1;AT12;AT127;30621;Mitterndorf an der Fischa;20_24;136;74;62;2021
AT1;AT12;AT127;30621;Mitterndorf an der Fischa;25_29;181;88;93;2021
AT1;AT12;AT127;30621;Mitterndorf an der Fischa;30_34;247;127;120;2021
AT1;AT12;AT127;30621;Mitterndorf an der Fischa;35_39;270;125;145;2021
AT1;AT12;AT127;30621;Mitterndorf an der Fischa;40_44;264;131;133;2021
AT1;AT12;AT127;30621;Mitterndorf an der Fischa;45_49;190;98;92;2021
AT1;AT12;AT127;30621;Mitterndorf an der Fischa;50_54;243;131;112;2021
AT1;AT12;AT127;30621;Mitterndorf an der Fischa;55_59;208;107;101;2021
AT1;AT12;AT127;30621;Mitterndorf an der Fischa;60_64;141;66;75;2021
AT1;AT12;AT127;30621;Mitterndorf an der Fischa;65_69;89;43;46;2021
AT1;AT12;AT127;30621;Mitterndorf an der Fischa;70_74;102;49;53;2021
AT1;AT12;AT127;30621;Mitterndorf an der Fischa;75_79;61;29;32;2021
AT1;AT12;AT127;30621;Mitterndorf an der Fischa;80_84;48;24;24;2021
AT1;AT12;AT127;30621;Mitterndorf an der Fischa;85_89;26;4;22;2021
AT1;AT12;AT127;30621;Mitterndorf an der Fischa;90_94;16;3;13;2021
AT1;AT12;AT127;30621;Mitterndorf an der Fischa;95_;1;0;1;2021
AT1;AT12;AT127;30623;Oberwaltersdorf;0_4;258;134;124;2021
AT1;AT12;AT127;30623;Oberwaltersdorf;5_9;318;155;163;2021
AT1;AT12;AT127;30623;Oberwaltersdorf;10_14;268;133;135;2021
AT1;AT12;AT127;30623;Oberwaltersdorf;15_19;247;125;122;2021
AT1;AT12;AT127;30623;Oberwaltersdorf;20_24;205;104;101;2021
AT1;AT12;AT127;30623;Oberwaltersdorf;25_29;211;102;109;2021
AT1;AT12;AT127;30623;Oberwaltersdorf;30_34;312;150;162;2021
AT1;AT12;AT127;30623;Oberwaltersdorf;35_39;352;172;180;2021
AT1;AT12;AT127;30623;Oberwaltersdorf;40_44;379;174;205;2021
AT1;AT12;AT127;30623;Oberwaltersdorf;45_49;358;171;187;2021
AT1;AT12;AT127;30623;Oberwaltersdorf;50_54;460;232;228;2021
AT1;AT12;AT127;30623;Oberwaltersdorf;55_59;426;201;225;2021
AT1;AT12;AT127;30623;Oberwaltersdorf;60_64;317;161;156;2021
AT1;AT12;AT127;30623;Oberwaltersdorf;65_69;219;105;114;2021
AT1;AT12;AT127;30623;Oberwaltersdorf;70_74;201;102;99;2021
AT1;AT12;AT127;30623;Oberwaltersdorf;75_79;158;74;84;2021
AT1;AT12;AT127;30623;Oberwaltersdorf;80_84;98;45;53;2021
AT1;AT12;AT127;30623;Oberwaltersdorf;85_89;49;18;31;2021
AT1;AT12;AT127;30623;Oberwaltersdorf;90_94;16;4;12;2021
AT1;AT12;AT127;30623;Oberwaltersdorf;95_;4;2;2;2021
AT1;AT12;AT127;30625;Pfaffst�tten;0_4;167;82;85;2021
AT1;AT12;AT127;30625;Pfaffst�tten;5_9;207;108;99;2021
AT1;AT12;AT127;30625;Pfaffst�tten;10_14;199;94;105;2021
AT1;AT12;AT127;30625;Pfaffst�tten;15_19;201;120;81;2021
AT1;AT12;AT127;30625;Pfaffst�tten;20_24;187;101;86;2021
AT1;AT12;AT127;30625;Pfaffst�tten;25_29;162;84;78;2021
AT1;AT12;AT127;30625;Pfaffst�tten;30_34;165;83;82;2021
AT1;AT12;AT127;30625;Pfaffst�tten;35_39;222;111;111;2021
AT1;AT12;AT127;30625;Pfaffst�tten;40_44;231;106;125;2021
AT1;AT12;AT127;30625;Pfaffst�tten;45_49;301;138;163;2021
AT1;AT12;AT127;30625;Pfaffst�tten;50_54;351;165;186;2021
AT1;AT12;AT127;30625;Pfaffst�tten;55_59;294;151;143;2021
AT1;AT12;AT127;30625;Pfaffst�tten;60_64;227;115;112;2021
AT1;AT12;AT127;30625;Pfaffst�tten;65_69;164;75;89;2021
AT1;AT12;AT127;30625;Pfaffst�tten;70_74;174;75;99;2021
AT1;AT12;AT127;30625;Pfaffst�tten;75_79;154;77;77;2021
AT1;AT12;AT127;30625;Pfaffst�tten;80_84;108;49;59;2021
AT1;AT12;AT127;30625;Pfaffst�tten;85_89;47;15;32;2021
AT1;AT12;AT127;30625;Pfaffst�tten;90_94;14;5;9;2021
AT1;AT12;AT127;30625;Pfaffst�tten;95_;2;2;0;2021
AT1;AT12;AT127;30626;Pottendorf;0_4;372;187;185;2021
AT1;AT12;AT127;30626;Pottendorf;5_9;392;225;167;2021
AT1;AT12;AT127;30626;Pottendorf;10_14;387;196;191;2021
AT1;AT12;AT127;30626;Pottendorf;15_19;358;201;157;2021
AT1;AT12;AT127;30626;Pottendorf;20_24;318;190;128;2021
AT1;AT12;AT127;30626;Pottendorf;25_29;425;214;211;2021
AT1;AT12;AT127;30626;Pottendorf;30_34;444;221;223;2021
AT1;AT12;AT127;30626;Pottendorf;35_39;581;298;283;2021
AT1;AT12;AT127;30626;Pottendorf;40_44;518;259;259;2021
AT1;AT12;AT127;30626;Pottendorf;45_49;522;265;257;2021
AT1;AT12;AT127;30626;Pottendorf;50_54;604;304;300;2021
AT1;AT12;AT127;30626;Pottendorf;55_59;587;290;297;2021
AT1;AT12;AT127;30626;Pottendorf;60_64;481;248;233;2021
AT1;AT12;AT127;30626;Pottendorf;65_69;363;166;197;2021
AT1;AT12;AT127;30626;Pottendorf;70_74;300;133;167;2021
AT1;AT12;AT127;30626;Pottendorf;75_79;301;134;167;2021
AT1;AT12;AT127;30626;Pottendorf;80_84;209;83;126;2021
AT1;AT12;AT127;30626;Pottendorf;85_89;111;47;64;2021
AT1;AT12;AT127;30626;Pottendorf;90_94;38;9;29;2021
AT1;AT12;AT127;30626;Pottendorf;95_;11;1;10;2021
AT1;AT12;AT122;30627;Pottenstein;0_4;126;73;53;2021
AT1;AT12;AT122;30627;Pottenstein;5_9;134;65;69;2021
AT1;AT12;AT122;30627;Pottenstein;10_14;134;76;58;2021
AT1;AT12;AT122;30627;Pottenstein;15_19;166;85;81;2021
AT1;AT12;AT122;30627;Pottenstein;20_24;158;82;76;2021
AT1;AT12;AT122;30627;Pottenstein;25_29;175;84;91;2021
AT1;AT12;AT122;30627;Pottenstein;30_34;176;86;90;2021
AT1;AT12;AT122;30627;Pottenstein;35_39;177;90;87;2021
AT1;AT12;AT122;30627;Pottenstein;40_44;146;75;71;2021
AT1;AT12;AT122;30627;Pottenstein;45_49;201;101;100;2021
AT1;AT12;AT122;30627;Pottenstein;50_54;263;127;136;2021
AT1;AT12;AT122;30627;Pottenstein;55_59;239;122;117;2021
AT1;AT12;AT122;30627;Pottenstein;60_64;188;95;93;2021
AT1;AT12;AT122;30627;Pottenstein;65_69;151;72;79;2021
AT1;AT12;AT122;30627;Pottenstein;70_74;150;66;84;2021
AT1;AT12;AT122;30627;Pottenstein;75_79;124;60;64;2021
AT1;AT12;AT122;30627;Pottenstein;80_84;107;41;66;2021
AT1;AT12;AT122;30627;Pottenstein;85_89;47;24;23;2021
AT1;AT12;AT122;30627;Pottenstein;90_94;23;6;17;2021
AT1;AT12;AT122;30627;Pottenstein;95_;4;0;4;2021
AT1;AT12;AT127;30629;Reisenberg;0_4;79;39;40;2021
AT1;AT12;AT127;30629;Reisenberg;5_9;94;46;48;2021
AT1;AT12;AT127;30629;Reisenberg;10_14;75;40;35;2021
AT1;AT12;AT127;30629;Reisenberg;15_19;83;38;45;2021
AT1;AT12;AT127;30629;Reisenberg;20_24;81;47;34;2021
AT1;AT12;AT127;30629;Reisenberg;25_29;99;55;44;2021
AT1;AT12;AT127;30629;Reisenberg;30_34;116;55;61;2021
AT1;AT12;AT127;30629;Reisenberg;35_39;108;58;50;2021
AT1;AT12;AT127;30629;Reisenberg;40_44;108;56;52;2021
AT1;AT12;AT127;30629;Reisenberg;45_49;155;84;71;2021
AT1;AT12;AT127;30629;Reisenberg;50_54;146;81;65;2021
AT1;AT12;AT127;30629;Reisenberg;55_59;147;74;73;2021
AT1;AT12;AT127;30629;Reisenberg;60_64;119;60;59;2021
AT1;AT12;AT127;30629;Reisenberg;65_69;109;61;48;2021
AT1;AT12;AT127;30629;Reisenberg;70_74;71;31;40;2021
AT1;AT12;AT127;30629;Reisenberg;75_79;68;36;32;2021
AT1;AT12;AT127;30629;Reisenberg;80_84;46;22;24;2021
AT1;AT12;AT127;30629;Reisenberg;85_89;29;11;18;2021
AT1;AT12;AT127;30629;Reisenberg;90_94;13;5;8;2021
AT1;AT12;AT127;30629;Reisenberg;95_;4;0;4;2021
AT1;AT12;AT127;30631;Sch�nau an der Triesting;0_4;90;46;44;2021
AT1;AT12;AT127;30631;Sch�nau an der Triesting;5_9;106;61;45;2021
AT1;AT12;AT127;30631;Sch�nau an der Triesting;10_14;124;66;58;2021
AT1;AT12;AT127;30631;Sch�nau an der Triesting;15_19;131;63;68;2021
AT1;AT12;AT127;30631;Sch�nau an der Triesting;20_24;100;58;42;2021
AT1;AT12;AT127;30631;Sch�nau an der Triesting;25_29;100;48;52;2021
AT1;AT12;AT127;30631;Sch�nau an der Triesting;30_34;126;55;71;2021
AT1;AT12;AT127;30631;Sch�nau an der Triesting;35_39;142;70;72;2021
AT1;AT12;AT127;30631;Sch�nau an der Triesting;40_44;143;60;83;2021
AT1;AT12;AT127;30631;Sch�nau an der Triesting;45_49;190;94;96;2021
AT1;AT12;AT127;30631;Sch�nau an der Triesting;50_54;205;105;100;2021
AT1;AT12;AT127;30631;Sch�nau an der Triesting;55_59;169;83;86;2021
AT1;AT12;AT127;30631;Sch�nau an der Triesting;60_64;154;75;79;2021
AT1;AT12;AT127;30631;Sch�nau an der Triesting;65_69;101;51;50;2021
AT1;AT12;AT127;30631;Sch�nau an der Triesting;70_74;99;47;52;2021
AT1;AT12;AT127;30631;Sch�nau an der Triesting;75_79;81;38;43;2021
AT1;AT12;AT127;30631;Sch�nau an der Triesting;80_84;52;18;34;2021
AT1;AT12;AT127;30631;Sch�nau an der Triesting;85_89;17;7;10;2021
AT1;AT12;AT127;30631;Sch�nau an der Triesting;90_94;5;1;4;2021
AT1;AT12;AT127;30631;Sch�nau an der Triesting;95_;2;0;2;2021
AT1;AT12;AT127;30633;Seibersdorf;0_4;63;40;23;2021
AT1;AT12;AT127;30633;Seibersdorf;5_9;72;41;31;2021
AT1;AT12;AT127;30633;Seibersdorf;10_14;87;41;46;2021
AT1;AT12;AT127;30633;Seibersdorf;15_19;69;37;32;2021
AT1;AT12;AT127;30633;Seibersdorf;20_24;71;39;32;2021
AT1;AT12;AT127;30633;Seibersdorf;25_29;82;43;39;2021
AT1;AT12;AT127;30633;Seibersdorf;30_34;89;48;41;2021
AT1;AT12;AT127;30633;Seibersdorf;35_39;126;56;70;2021
AT1;AT12;AT127;30633;Seibersdorf;40_44;103;49;54;2021
AT1;AT12;AT127;30633;Seibersdorf;45_49;99;50;49;2021
AT1;AT12;AT127;30633;Seibersdorf;50_54;110;54;56;2021
AT1;AT12;AT127;30633;Seibersdorf;55_59;123;58;65;2021
AT1;AT12;AT127;30633;Seibersdorf;60_64;122;63;59;2021
AT1;AT12;AT127;30633;Seibersdorf;65_69;109;61;48;2021
AT1;AT12;AT127;30633;Seibersdorf;70_74;74;38;36;2021
AT1;AT12;AT127;30633;Seibersdorf;75_79;62;29;33;2021
AT1;AT12;AT127;30633;Seibersdorf;80_84;44;16;28;2021
AT1;AT12;AT127;30633;Seibersdorf;85_89;14;4;10;2021
AT1;AT12;AT127;30633;Seibersdorf;90_94;8;3;5;2021
AT1;AT12;AT127;30633;Seibersdorf;95_;2;0;2;2021
AT1;AT12;AT127;30635;Soo�;0_4;41;16;25;2021
AT1;AT12;AT127;30635;Soo�;5_9;39;20;19;2021
AT1;AT12;AT127;30635;Soo�;10_14;51;29;22;2021
AT1;AT12;AT127;30635;Soo�;15_19;52;30;22;2021
AT1;AT12;AT127;30635;Soo�;20_24;57;25;32;2021
AT1;AT12;AT127;30635;Soo�;25_29;65;37;28;2021
AT1;AT12;AT127;30635;Soo�;30_34;44;23;21;2021
AT1;AT12;AT127;30635;Soo�;35_39;60;35;25;2021
AT1;AT12;AT127;30635;Soo�;40_44;73;34;39;2021
AT1;AT12;AT127;30635;Soo�;45_49;79;42;37;2021
AT1;AT12;AT127;30635;Soo�;50_54;98;43;55;2021
AT1;AT12;AT127;30635;Soo�;55_59;92;50;42;2021
AT1;AT12;AT127;30635;Soo�;60_64;69;34;35;2021
AT1;AT12;AT127;30635;Soo�;65_69;50;23;27;2021
AT1;AT12;AT127;30635;Soo�;70_74;62;25;37;2021
AT1;AT12;AT127;30635;Soo�;75_79;47;23;24;2021
AT1;AT12;AT127;30635;Soo�;80_84;29;11;18;2021
AT1;AT12;AT127;30635;Soo�;85_89;26;12;14;2021
AT1;AT12;AT127;30635;Soo�;90_94;7;3;4;2021
AT1;AT12;AT127;30635;Soo�;95_;1;0;1;2021
AT1;AT12;AT127;30636;Tattendorf;0_4;65;33;32;2021
AT1;AT12;AT127;30636;Tattendorf;5_9;76;41;35;2021
AT1;AT12;AT127;30636;Tattendorf;10_14;67;41;26;2021
AT1;AT12;AT127;30636;Tattendorf;15_19;83;41;42;2021
AT1;AT12;AT127;30636;Tattendorf;20_24;63;35;28;2021
AT1;AT12;AT127;30636;Tattendorf;25_29;65;34;31;2021
AT1;AT12;AT127;30636;Tattendorf;30_34;80;35;45;2021
AT1;AT12;AT127;30636;Tattendorf;35_39;95;50;45;2021
AT1;AT12;AT127;30636;Tattendorf;40_44;99;46;53;2021
AT1;AT12;AT127;30636;Tattendorf;45_49;105;62;43;2021
AT1;AT12;AT127;30636;Tattendorf;50_54;150;77;73;2021
AT1;AT12;AT127;30636;Tattendorf;55_59;123;58;65;2021
AT1;AT12;AT127;30636;Tattendorf;60_64;90;44;46;2021
AT1;AT12;AT127;30636;Tattendorf;65_69;71;32;39;2021
AT1;AT12;AT127;30636;Tattendorf;70_74;72;37;35;2021
AT1;AT12;AT127;30636;Tattendorf;75_79;82;39;43;2021
AT1;AT12;AT127;30636;Tattendorf;80_84;38;16;22;2021
AT1;AT12;AT127;30636;Tattendorf;85_89;12;5;7;2021
AT1;AT12;AT127;30636;Tattendorf;90_94;4;1;3;2021
AT1;AT12;AT127;30636;Tattendorf;95_;0;0;0;2021
AT1;AT12;AT127;30637;Teesdorf;0_4;85;45;40;2021
AT1;AT12;AT127;30637;Teesdorf;5_9;68;31;37;2021
AT1;AT12;AT127;30637;Teesdorf;10_14;103;54;49;2021
AT1;AT12;AT127;30637;Teesdorf;15_19;105;66;39;2021
AT1;AT12;AT127;30637;Teesdorf;20_24;103;56;47;2021
AT1;AT12;AT127;30637;Teesdorf;25_29;120;55;65;2021
AT1;AT12;AT127;30637;Teesdorf;30_34;113;57;56;2021
AT1;AT12;AT127;30637;Teesdorf;35_39;95;40;55;2021
AT1;AT12;AT127;30637;Teesdorf;40_44;114;43;71;2021
AT1;AT12;AT127;30637;Teesdorf;45_49;155;70;85;2021
AT1;AT12;AT127;30637;Teesdorf;50_54;182;87;95;2021
AT1;AT12;AT127;30637;Teesdorf;55_59;176;94;82;2021
AT1;AT12;AT127;30637;Teesdorf;60_64;127;63;64;2021
AT1;AT12;AT127;30637;Teesdorf;65_69;63;27;36;2021
AT1;AT12;AT127;30637;Teesdorf;70_74;62;29;33;2021
AT1;AT12;AT127;30637;Teesdorf;75_79;57;20;37;2021
AT1;AT12;AT127;30637;Teesdorf;80_84;50;26;24;2021
AT1;AT12;AT127;30637;Teesdorf;85_89;17;6;11;2021
AT1;AT12;AT127;30637;Teesdorf;90_94;10;6;4;2021
AT1;AT12;AT127;30637;Teesdorf;95_;0;0;0;2021
AT1;AT12;AT127;30639;Traiskirchen;0_4;843;445;398;2021
AT1;AT12;AT127;30639;Traiskirchen;5_9;990;512;478;2021
AT1;AT12;AT127;30639;Traiskirchen;10_14;931;472;459;2021
AT1;AT12;AT127;30639;Traiskirchen;15_19;1059;579;480;2021
AT1;AT12;AT127;30639;Traiskirchen;20_24;984;522;462;2021
AT1;AT12;AT127;30639;Traiskirchen;25_29;1049;558;491;2021
AT1;AT12;AT127;30639;Traiskirchen;30_34;1113;562;551;2021
AT1;AT12;AT127;30639;Traiskirchen;35_39;1304;646;658;2021
AT1;AT12;AT127;30639;Traiskirchen;40_44;1245;583;662;2021
AT1;AT12;AT127;30639;Traiskirchen;45_49;1501;727;774;2021
AT1;AT12;AT127;30639;Traiskirchen;50_54;1709;842;867;2021
AT1;AT12;AT127;30639;Traiskirchen;55_59;1563;799;764;2021
AT1;AT12;AT127;30639;Traiskirchen;60_64;1127;555;572;2021
AT1;AT12;AT127;30639;Traiskirchen;65_69;912;412;500;2021
AT1;AT12;AT127;30639;Traiskirchen;70_74;832;417;415;2021
AT1;AT12;AT127;30639;Traiskirchen;75_79;716;309;407;2021
AT1;AT12;AT127;30639;Traiskirchen;80_84;544;220;324;2021
AT1;AT12;AT127;30639;Traiskirchen;85_89;235;86;149;2021
AT1;AT12;AT127;30639;Traiskirchen;90_94;95;25;70;2021
AT1;AT12;AT127;30639;Traiskirchen;95_;22;2;20;2021
AT1;AT12;AT127;30641;Trumau;0_4;173;84;89;2021
AT1;AT12;AT127;30641;Trumau;5_9;207;102;105;2021
AT1;AT12;AT127;30641;Trumau;10_14;198;111;87;2021
AT1;AT12;AT127;30641;Trumau;15_19;188;94;94;2021
AT1;AT12;AT127;30641;Trumau;20_24;176;90;86;2021
AT1;AT12;AT127;30641;Trumau;25_29;218;101;117;2021
AT1;AT12;AT127;30641;Trumau;30_34;233;118;115;2021
AT1;AT12;AT127;30641;Trumau;35_39;281;133;148;2021
AT1;AT12;AT127;30641;Trumau;40_44;293;147;146;2021
AT1;AT12;AT127;30641;Trumau;45_49;314;160;154;2021
AT1;AT12;AT127;30641;Trumau;50_54;317;169;148;2021
AT1;AT12;AT127;30641;Trumau;55_59;308;150;158;2021
AT1;AT12;AT127;30641;Trumau;60_64;211;95;116;2021
AT1;AT12;AT127;30641;Trumau;65_69;174;76;98;2021
AT1;AT12;AT127;30641;Trumau;70_74;152;80;72;2021
AT1;AT12;AT127;30641;Trumau;75_79;121;51;70;2021
AT1;AT12;AT127;30641;Trumau;80_84;91;45;46;2021
AT1;AT12;AT127;30641;Trumau;85_89;38;15;23;2021
AT1;AT12;AT127;30641;Trumau;90_94;20;8;12;2021
AT1;AT12;AT127;30641;Trumau;95_;5;1;4;2021
AT1;AT12;AT122;30645;Weissenbach an der Triesting;0_4;69;44;25;2021
AT1;AT12;AT122;30645;Weissenbach an der Triesting;5_9;96;44;52;2021
AT1;AT12;AT122;30645;Weissenbach an der Triesting;10_14;99;51;48;2021
AT1;AT12;AT122;30645;Weissenbach an der Triesting;15_19;101;42;59;2021
AT1;AT12;AT122;30645;Weissenbach an der Triesting;20_24;73;36;37;2021
AT1;AT12;AT122;30645;Weissenbach an der Triesting;25_29;97;48;49;2021
AT1;AT12;AT122;30645;Weissenbach an der Triesting;30_34;95;43;52;2021
AT1;AT12;AT122;30645;Weissenbach an der Triesting;35_39;132;66;66;2021
AT1;AT12;AT122;30645;Weissenbach an der Triesting;40_44;103;54;49;2021
AT1;AT12;AT122;30645;Weissenbach an der Triesting;45_49;110;55;55;2021
AT1;AT12;AT122;30645;Weissenbach an der Triesting;50_54;124;70;54;2021
AT1;AT12;AT122;30645;Weissenbach an der Triesting;55_59;148;73;75;2021
AT1;AT12;AT122;30645;Weissenbach an der Triesting;60_64;129;64;65;2021
AT1;AT12;AT122;30645;Weissenbach an der Triesting;65_69;97;46;51;2021
AT1;AT12;AT122;30645;Weissenbach an der Triesting;70_74;86;38;48;2021
AT1;AT12;AT122;30645;Weissenbach an der Triesting;75_79;69;34;35;2021
AT1;AT12;AT122;30645;Weissenbach an der Triesting;80_84;54;23;31;2021
AT1;AT12;AT122;30645;Weissenbach an der Triesting;85_89;25;10;15;2021
AT1;AT12;AT122;30645;Weissenbach an der Triesting;90_94;13;5;8;2021
AT1;AT12;AT122;30645;Weissenbach an der Triesting;95_;3;1;2;2021
AT1;AT12;AT127;30646;Blumau-Neuri�hof;0_4;84;43;41;2021
AT1;AT12;AT127;30646;Blumau-Neuri�hof;5_9;101;59;42;2021
AT1;AT12;AT127;30646;Blumau-Neuri�hof;10_14;93;46;47;2021
AT1;AT12;AT127;30646;Blumau-Neuri�hof;15_19;75;40;35;2021
AT1;AT12;AT127;30646;Blumau-Neuri�hof;20_24;89;45;44;2021
AT1;AT12;AT127;30646;Blumau-Neuri�hof;25_29;117;56;61;2021
AT1;AT12;AT127;30646;Blumau-Neuri�hof;30_34;142;77;65;2021
AT1;AT12;AT127;30646;Blumau-Neuri�hof;35_39;132;64;68;2021
AT1;AT12;AT127;30646;Blumau-Neuri�hof;40_44;128;56;72;2021
AT1;AT12;AT127;30646;Blumau-Neuri�hof;45_49;153;78;75;2021
AT1;AT12;AT127;30646;Blumau-Neuri�hof;50_54;184;100;84;2021
AT1;AT12;AT127;30646;Blumau-Neuri�hof;55_59;167;77;90;2021
AT1;AT12;AT127;30646;Blumau-Neuri�hof;60_64;121;59;62;2021
AT1;AT12;AT127;30646;Blumau-Neuri�hof;65_69;86;42;44;2021
AT1;AT12;AT127;30646;Blumau-Neuri�hof;70_74;70;31;39;2021
AT1;AT12;AT127;30646;Blumau-Neuri�hof;75_79;77;38;39;2021
AT1;AT12;AT127;30646;Blumau-Neuri�hof;80_84;44;18;26;2021
AT1;AT12;AT127;30646;Blumau-Neuri�hof;85_89;18;9;9;2021
AT1;AT12;AT127;30646;Blumau-Neuri�hof;90_94;9;2;7;2021
AT1;AT12;AT127;30646;Blumau-Neuri�hof;95_;1;0;1;2021
AT1;AT12;AT127;30701;Au am Leithaberge;0_4;56;26;30;2021
AT1;AT12;AT127;30701;Au am Leithaberge;5_9;39;22;17;2021
AT1;AT12;AT127;30701;Au am Leithaberge;10_14;40;20;20;2021
AT1;AT12;AT127;30701;Au am Leithaberge;15_19;33;17;16;2021
AT1;AT12;AT127;30701;Au am Leithaberge;20_24;38;24;14;2021
AT1;AT12;AT127;30701;Au am Leithaberge;25_29;48;20;28;2021
AT1;AT12;AT127;30701;Au am Leithaberge;30_34;65;30;35;2021
AT1;AT12;AT127;30701;Au am Leithaberge;35_39;74;45;29;2021
AT1;AT12;AT127;30701;Au am Leithaberge;40_44;55;20;35;2021
AT1;AT12;AT127;30701;Au am Leithaberge;45_49;61;30;31;2021
AT1;AT12;AT127;30701;Au am Leithaberge;50_54;89;53;36;2021
AT1;AT12;AT127;30701;Au am Leithaberge;55_59;75;34;41;2021
AT1;AT12;AT127;30701;Au am Leithaberge;60_64;63;29;34;2021
AT1;AT12;AT127;30701;Au am Leithaberge;65_69;53;28;25;2021
AT1;AT12;AT127;30701;Au am Leithaberge;70_74;55;29;26;2021
AT1;AT12;AT127;30701;Au am Leithaberge;75_79;32;13;19;2021
AT1;AT12;AT127;30701;Au am Leithaberge;80_84;37;16;21;2021
AT1;AT12;AT127;30701;Au am Leithaberge;85_89;24;7;17;2021
AT1;AT12;AT127;30701;Au am Leithaberge;90_94;8;1;7;2021
AT1;AT12;AT127;30701;Au am Leithaberge;95_;6;1;5;2021
AT1;AT12;AT127;30702;Bad Deutsch-Altenburg;0_4;94;45;49;2021
AT1;AT12;AT127;30702;Bad Deutsch-Altenburg;5_9;113;52;61;2021
AT1;AT12;AT127;30702;Bad Deutsch-Altenburg;10_14;81;44;37;2021
AT1;AT12;AT127;30702;Bad Deutsch-Altenburg;15_19;80;39;41;2021
AT1;AT12;AT127;30702;Bad Deutsch-Altenburg;20_24;104;48;56;2021
AT1;AT12;AT127;30702;Bad Deutsch-Altenburg;25_29;105;51;54;2021
AT1;AT12;AT127;30702;Bad Deutsch-Altenburg;30_34;132;69;63;2021
AT1;AT12;AT127;30702;Bad Deutsch-Altenburg;35_39;136;56;80;2021
AT1;AT12;AT127;30702;Bad Deutsch-Altenburg;40_44;129;64;65;2021
AT1;AT12;AT127;30702;Bad Deutsch-Altenburg;45_49;136;65;71;2021
AT1;AT12;AT127;30702;Bad Deutsch-Altenburg;50_54;138;72;66;2021
AT1;AT12;AT127;30702;Bad Deutsch-Altenburg;55_59;148;68;80;2021
AT1;AT12;AT127;30702;Bad Deutsch-Altenburg;60_64;146;66;80;2021
AT1;AT12;AT127;30702;Bad Deutsch-Altenburg;65_69;98;41;57;2021
AT1;AT12;AT127;30702;Bad Deutsch-Altenburg;70_74;85;39;46;2021
AT1;AT12;AT127;30702;Bad Deutsch-Altenburg;75_79;75;32;43;2021
AT1;AT12;AT127;30702;Bad Deutsch-Altenburg;80_84;64;29;35;2021
AT1;AT12;AT127;30702;Bad Deutsch-Altenburg;85_89;25;10;15;2021
AT1;AT12;AT127;30702;Bad Deutsch-Altenburg;90_94;13;4;9;2021
AT1;AT12;AT127;30702;Bad Deutsch-Altenburg;95_;4;0;4;2021
AT1;AT12;AT127;30703;Berg;0_4;61;31;30;2021
AT1;AT12;AT127;30703;Berg;5_9;69;32;37;2021
AT1;AT12;AT127;30703;Berg;10_14;41;17;24;2021
AT1;AT12;AT127;30703;Berg;15_19;49;24;25;2021
AT1;AT12;AT127;30703;Berg;20_24;31;14;17;2021
AT1;AT12;AT127;30703;Berg;25_29;27;17;10;2021
AT1;AT12;AT127;30703;Berg;30_34;45;18;27;2021
AT1;AT12;AT127;30703;Berg;35_39;86;39;47;2021
AT1;AT12;AT127;30703;Berg;40_44;67;33;34;2021
AT1;AT12;AT127;30703;Berg;45_49;72;38;34;2021
AT1;AT12;AT127;30703;Berg;50_54;68;33;35;2021
AT1;AT12;AT127;30703;Berg;55_59;57;27;30;2021
AT1;AT12;AT127;30703;Berg;60_64;61;26;35;2021
AT1;AT12;AT127;30703;Berg;65_69;45;27;18;2021
AT1;AT12;AT127;30703;Berg;70_74;58;25;33;2021
AT1;AT12;AT127;30703;Berg;75_79;35;16;19;2021
AT1;AT12;AT127;30703;Berg;80_84;23;10;13;2021
AT1;AT12;AT127;30703;Berg;85_89;8;2;6;2021
AT1;AT12;AT127;30703;Berg;90_94;11;6;5;2021
AT1;AT12;AT127;30703;Berg;95_;0;0;0;2021
AT1;AT12;AT127;30704;Bruck an der Leitha;0_4;365;195;170;2021
AT1;AT12;AT127;30704;Bruck an der Leitha;5_9;434;237;197;2021
AT1;AT12;AT127;30704;Bruck an der Leitha;10_14;408;206;202;2021
AT1;AT12;AT127;30704;Bruck an der Leitha;15_19;395;197;198;2021
AT1;AT12;AT127;30704;Bruck an der Leitha;20_24;406;201;205;2021
AT1;AT12;AT127;30704;Bruck an der Leitha;25_29;464;246;218;2021
AT1;AT12;AT127;30704;Bruck an der Leitha;30_34;500;237;263;2021
AT1;AT12;AT127;30704;Bruck an der Leitha;35_39;532;269;263;2021
AT1;AT12;AT127;30704;Bruck an der Leitha;40_44;514;250;264;2021
AT1;AT12;AT127;30704;Bruck an der Leitha;45_49;578;281;297;2021
AT1;AT12;AT127;30704;Bruck an der Leitha;50_54;614;303;311;2021
AT1;AT12;AT127;30704;Bruck an der Leitha;55_59;627;307;320;2021
AT1;AT12;AT127;30704;Bruck an der Leitha;60_64;564;274;290;2021
AT1;AT12;AT127;30704;Bruck an der Leitha;65_69;443;201;242;2021
AT1;AT12;AT127;30704;Bruck an der Leitha;70_74;422;190;232;2021
AT1;AT12;AT127;30704;Bruck an der Leitha;75_79;343;161;182;2021
AT1;AT12;AT127;30704;Bruck an der Leitha;80_84;280;114;166;2021
AT1;AT12;AT127;30704;Bruck an der Leitha;85_89;147;66;81;2021
AT1;AT12;AT127;30704;Bruck an der Leitha;90_94;92;28;64;2021
AT1;AT12;AT127;30704;Bruck an der Leitha;95_;25;7;18;2021
AT1;AT12;AT127;30706;Enzersdorf an der Fischa;0_4;190;100;90;2021
AT1;AT12;AT127;30706;Enzersdorf an der Fischa;5_9;185;95;90;2021
AT1;AT12;AT127;30706;Enzersdorf an der Fischa;10_14;125;62;63;2021
AT1;AT12;AT127;30706;Enzersdorf an der Fischa;15_19;135;78;57;2021
AT1;AT12;AT127;30706;Enzersdorf an der Fischa;20_24;151;79;72;2021
AT1;AT12;AT127;30706;Enzersdorf an der Fischa;25_29;217;110;107;2021
AT1;AT12;AT127;30706;Enzersdorf an der Fischa;30_34;247;123;124;2021
AT1;AT12;AT127;30706;Enzersdorf an der Fischa;35_39;251;129;122;2021
AT1;AT12;AT127;30706;Enzersdorf an der Fischa;40_44;203;102;101;2021
AT1;AT12;AT127;30706;Enzersdorf an der Fischa;45_49;230;114;116;2021
AT1;AT12;AT127;30706;Enzersdorf an der Fischa;50_54;308;143;165;2021
AT1;AT12;AT127;30706;Enzersdorf an der Fischa;55_59;310;159;151;2021
AT1;AT12;AT127;30706;Enzersdorf an der Fischa;60_64;217;115;102;2021
AT1;AT12;AT127;30706;Enzersdorf an der Fischa;65_69;181;82;99;2021
AT1;AT12;AT127;30706;Enzersdorf an der Fischa;70_74;166;72;94;2021
AT1;AT12;AT127;30706;Enzersdorf an der Fischa;75_79;124;56;68;2021
AT1;AT12;AT127;30706;Enzersdorf an der Fischa;80_84;97;48;49;2021
AT1;AT12;AT127;30706;Enzersdorf an der Fischa;85_89;59;26;33;2021
AT1;AT12;AT127;30706;Enzersdorf an der Fischa;90_94;22;7;15;2021
AT1;AT12;AT127;30706;Enzersdorf an der Fischa;95_;4;1;3;2021
AT1;AT12;AT127;30708;G�ttlesbrunn-Arbesthal;0_4;54;26;28;2021
AT1;AT12;AT127;30708;G�ttlesbrunn-Arbesthal;5_9;85;36;49;2021
AT1;AT12;AT127;30708;G�ttlesbrunn-Arbesthal;10_14;77;40;37;2021
AT1;AT12;AT127;30708;G�ttlesbrunn-Arbesthal;15_19;65;32;33;2021
AT1;AT12;AT127;30708;G�ttlesbrunn-Arbesthal;20_24;61;31;30;2021
AT1;AT12;AT127;30708;G�ttlesbrunn-Arbesthal;25_29;72;38;34;2021
AT1;AT12;AT127;30708;G�ttlesbrunn-Arbesthal;30_34;84;45;39;2021
AT1;AT12;AT127;30708;G�ttlesbrunn-Arbesthal;35_39;95;41;54;2021
AT1;AT12;AT127;30708;G�ttlesbrunn-Arbesthal;40_44;94;43;51;2021
AT1;AT12;AT127;30708;G�ttlesbrunn-Arbesthal;45_49;110;57;53;2021
AT1;AT12;AT127;30708;G�ttlesbrunn-Arbesthal;50_54;119;60;59;2021
AT1;AT12;AT127;30708;G�ttlesbrunn-Arbesthal;55_59;135;70;65;2021
AT1;AT12;AT127;30708;G�ttlesbrunn-Arbesthal;60_64;95;47;48;2021
AT1;AT12;AT127;30708;G�ttlesbrunn-Arbesthal;65_69;109;58;51;2021
AT1;AT12;AT127;30708;G�ttlesbrunn-Arbesthal;70_74;84;42;42;2021
AT1;AT12;AT127;30708;G�ttlesbrunn-Arbesthal;75_79;44;18;26;2021
AT1;AT12;AT127;30708;G�ttlesbrunn-Arbesthal;80_84;37;17;20;2021
AT1;AT12;AT127;30708;G�ttlesbrunn-Arbesthal;85_89;22;6;16;2021
AT1;AT12;AT127;30708;G�ttlesbrunn-Arbesthal;90_94;8;4;4;2021
AT1;AT12;AT127;30708;G�ttlesbrunn-Arbesthal;95_;0;0;0;2021
AT1;AT12;AT127;30709;G�tzendorf an der Leitha;0_4;110;57;53;2021
AT1;AT12;AT127;30709;G�tzendorf an der Leitha;5_9;106;60;46;2021
AT1;AT12;AT127;30709;G�tzendorf an der Leitha;10_14;102;57;45;2021
AT1;AT12;AT127;30709;G�tzendorf an der Leitha;15_19;124;60;64;2021
AT1;AT12;AT127;30709;G�tzendorf an der Leitha;20_24;91;44;47;2021
AT1;AT12;AT127;30709;G�tzendorf an der Leitha;25_29;108;52;56;2021
AT1;AT12;AT127;30709;G�tzendorf an der Leitha;30_34;139;76;63;2021
AT1;AT12;AT127;30709;G�tzendorf an der Leitha;35_39;151;73;78;2021
AT1;AT12;AT127;30709;G�tzendorf an der Leitha;40_44;146;69;77;2021
AT1;AT12;AT127;30709;G�tzendorf an der Leitha;45_49;157;86;71;2021
AT1;AT12;AT127;30709;G�tzendorf an der Leitha;50_54;159;78;81;2021
AT1;AT12;AT127;30709;G�tzendorf an der Leitha;55_59;204;104;100;2021
AT1;AT12;AT127;30709;G�tzendorf an der Leitha;60_64;139;68;71;2021
AT1;AT12;AT127;30709;G�tzendorf an der Leitha;65_69;108;51;57;2021
AT1;AT12;AT127;30709;G�tzendorf an der Leitha;70_74;109;46;63;2021
AT1;AT12;AT127;30709;G�tzendorf an der Leitha;75_79;82;44;38;2021
AT1;AT12;AT127;30709;G�tzendorf an der Leitha;80_84;61;22;39;2021
AT1;AT12;AT127;30709;G�tzendorf an der Leitha;85_89;33;17;16;2021
AT1;AT12;AT127;30709;G�tzendorf an der Leitha;90_94;14;4;10;2021
AT1;AT12;AT127;30709;G�tzendorf an der Leitha;95_;4;0;4;2021
AT1;AT12;AT127;30710;Hainburg a. d. Donau;0_4;426;229;197;2021
AT1;AT12;AT127;30710;Hainburg a. d. Donau;5_9;485;249;236;2021
AT1;AT12;AT127;30710;Hainburg a. d. Donau;10_14;410;204;206;2021
AT1;AT12;AT127;30710;Hainburg a. d. Donau;15_19;340;167;173;2021
AT1;AT12;AT127;30710;Hainburg a. d. Donau;20_24;279;139;140;2021
AT1;AT12;AT127;30710;Hainburg a. d. Donau;25_29;306;140;166;2021
AT1;AT12;AT127;30710;Hainburg a. d. Donau;30_34;389;184;205;2021
AT1;AT12;AT127;30710;Hainburg a. d. Donau;35_39;548;265;283;2021
AT1;AT12;AT127;30710;Hainburg a. d. Donau;40_44;542;256;286;2021
AT1;AT12;AT127;30710;Hainburg a. d. Donau;45_49;483;247;236;2021
AT1;AT12;AT127;30710;Hainburg a. d. Donau;50_54;479;243;236;2021
AT1;AT12;AT127;30710;Hainburg a. d. Donau;55_59;460;218;242;2021
AT1;AT12;AT127;30710;Hainburg a. d. Donau;60_64;457;217;240;2021
AT1;AT12;AT127;30710;Hainburg a. d. Donau;65_69;368;171;197;2021
AT1;AT12;AT127;30710;Hainburg a. d. Donau;70_74;351;146;205;2021
AT1;AT12;AT127;30710;Hainburg a. d. Donau;75_79;270;123;147;2021
AT1;AT12;AT127;30710;Hainburg a. d. Donau;80_84;222;98;124;2021
AT1;AT12;AT127;30710;Hainburg a. d. Donau;85_89;94;38;56;2021
AT1;AT12;AT127;30710;Hainburg a. d. Donau;90_94;52;14;38;2021
AT1;AT12;AT127;30710;Hainburg a. d. Donau;95_;14;4;10;2021
AT1;AT12;AT127;30711;Haslau-Maria Ellend;0_4;91;48;43;2021
AT1;AT12;AT127;30711;Haslau-Maria Ellend;5_9;115;51;64;2021
AT1;AT12;AT127;30711;Haslau-Maria Ellend;10_14;139;73;66;2021
AT1;AT12;AT127;30711;Haslau-Maria Ellend;15_19;135;74;61;2021
AT1;AT12;AT127;30711;Haslau-Maria Ellend;20_24;103;49;54;2021
AT1;AT12;AT127;30711;Haslau-Maria Ellend;25_29;72;42;30;2021
AT1;AT12;AT127;30711;Haslau-Maria Ellend;30_34;88;33;55;2021
AT1;AT12;AT127;30711;Haslau-Maria Ellend;35_39;134;66;68;2021
AT1;AT12;AT127;30711;Haslau-Maria Ellend;40_44;173;79;94;2021
AT1;AT12;AT127;30711;Haslau-Maria Ellend;45_49;182;80;102;2021
AT1;AT12;AT127;30711;Haslau-Maria Ellend;50_54;206;113;93;2021
AT1;AT12;AT127;30711;Haslau-Maria Ellend;55_59;148;80;68;2021
AT1;AT12;AT127;30711;Haslau-Maria Ellend;60_64;154;77;77;2021
AT1;AT12;AT127;30711;Haslau-Maria Ellend;65_69;84;43;41;2021
AT1;AT12;AT127;30711;Haslau-Maria Ellend;70_74;66;33;33;2021
AT1;AT12;AT127;30711;Haslau-Maria Ellend;75_79;69;29;40;2021
AT1;AT12;AT127;30711;Haslau-Maria Ellend;80_84;45;19;26;2021
AT1;AT12;AT127;30711;Haslau-Maria Ellend;85_89;17;6;11;2021
AT1;AT12;AT127;30711;Haslau-Maria Ellend;90_94;14;5;9;2021
AT1;AT12;AT127;30711;Haslau-Maria Ellend;95_;0;0;0;2021
AT1;AT12;AT127;30712;H�flein;0_4;59;24;35;2021
AT1;AT12;AT127;30712;H�flein;5_9;64;29;35;2021
AT1;AT12;AT127;30712;H�flein;10_14;58;30;28;2021
AT1;AT12;AT127;30712;H�flein;15_19;74;38;36;2021
AT1;AT12;AT127;30712;H�flein;20_24;57;28;29;2021
AT1;AT12;AT127;30712;H�flein;25_29;59;31;28;2021
AT1;AT12;AT127;30712;H�flein;30_34;77;38;39;2021
AT1;AT12;AT127;30712;H�flein;35_39;74;36;38;2021
AT1;AT12;AT127;30712;H�flein;40_44;82;41;41;2021
AT1;AT12;AT127;30712;H�flein;45_49;79;34;45;2021
AT1;AT12;AT127;30712;H�flein;50_54;120;59;61;2021
AT1;AT12;AT127;30712;H�flein;55_59;122;60;62;2021
AT1;AT12;AT127;30712;H�flein;60_64;81;44;37;2021
AT1;AT12;AT127;30712;H�flein;65_69;73;37;36;2021
AT1;AT12;AT127;30712;H�flein;70_74;45;24;21;2021
AT1;AT12;AT127;30712;H�flein;75_79;45;24;21;2021
AT1;AT12;AT127;30712;H�flein;80_84;35;14;21;2021
AT1;AT12;AT127;30712;H�flein;85_89;20;6;14;2021
AT1;AT12;AT127;30712;H�flein;90_94;7;3;4;2021
AT1;AT12;AT127;30712;H�flein;95_;1;0;1;2021
AT1;AT12;AT127;30713;Hof am Leithaberge;0_4;80;43;37;2021
AT1;AT12;AT127;30713;Hof am Leithaberge;5_9;61;33;28;2021
AT1;AT12;AT127;30713;Hof am Leithaberge;10_14;90;37;53;2021
AT1;AT12;AT127;30713;Hof am Leithaberge;15_19;89;51;38;2021
AT1;AT12;AT127;30713;Hof am Leithaberge;20_24;84;42;42;2021
AT1;AT12;AT127;30713;Hof am Leithaberge;25_29;92;51;41;2021
AT1;AT12;AT127;30713;Hof am Leithaberge;30_34;93;42;51;2021
AT1;AT12;AT127;30713;Hof am Leithaberge;35_39;98;54;44;2021
AT1;AT12;AT127;30713;Hof am Leithaberge;40_44;98;48;50;2021
AT1;AT12;AT127;30713;Hof am Leithaberge;45_49;123;66;57;2021
AT1;AT12;AT127;30713;Hof am Leithaberge;50_54;138;71;67;2021
AT1;AT12;AT127;30713;Hof am Leithaberge;55_59;118;53;65;2021
AT1;AT12;AT127;30713;Hof am Leithaberge;60_64;112;60;52;2021
AT1;AT12;AT127;30713;Hof am Leithaberge;65_69;90;50;40;2021
AT1;AT12;AT127;30713;Hof am Leithaberge;70_74;84;42;42;2021
AT1;AT12;AT127;30713;Hof am Leithaberge;75_79;49;21;28;2021
AT1;AT12;AT127;30713;Hof am Leithaberge;80_84;52;22;30;2021
AT1;AT12;AT127;30713;Hof am Leithaberge;85_89;24;9;15;2021
AT1;AT12;AT127;30713;Hof am Leithaberge;90_94;13;4;9;2021
AT1;AT12;AT127;30713;Hof am Leithaberge;95_;4;0;4;2021
AT1;AT12;AT127;30715;Hundsheim;0_4;38;20;18;2021
AT1;AT12;AT127;30715;Hundsheim;5_9;24;12;12;2021
AT1;AT12;AT127;30715;Hundsheim;10_14;33;10;23;2021
AT1;AT12;AT127;30715;Hundsheim;15_19;32;11;21;2021
AT1;AT12;AT127;30715;Hundsheim;20_24;25;12;13;2021
AT1;AT12;AT127;30715;Hundsheim;25_29;38;21;17;2021
AT1;AT12;AT127;30715;Hundsheim;30_34;28;12;16;2021
AT1;AT12;AT127;30715;Hundsheim;35_39;43;22;21;2021
AT1;AT12;AT127;30715;Hundsheim;40_44;44;19;25;2021
AT1;AT12;AT127;30715;Hundsheim;45_49;46;21;25;2021
AT1;AT12;AT127;30715;Hundsheim;50_54;44;22;22;2021
AT1;AT12;AT127;30715;Hundsheim;55_59;53;26;27;2021
AT1;AT12;AT127;30715;Hundsheim;60_64;46;24;22;2021
AT1;AT12;AT127;30715;Hundsheim;65_69;39;21;18;2021
AT1;AT12;AT127;30715;Hundsheim;70_74;33;17;16;2021
AT1;AT12;AT127;30715;Hundsheim;75_79;29;13;16;2021
AT1;AT12;AT127;30715;Hundsheim;80_84;27;8;19;2021
AT1;AT12;AT127;30715;Hundsheim;85_89;12;5;7;2021
AT1;AT12;AT127;30715;Hundsheim;90_94;6;1;5;2021
AT1;AT12;AT127;30715;Hundsheim;95_;1;0;1;2021
AT1;AT12;AT127;30716;Mannersdorf am Leithagebirge;0_4;216;107;109;2021
AT1;AT12;AT127;30716;Mannersdorf am Leithagebirge;5_9;196;100;96;2021
AT1;AT12;AT127;30716;Mannersdorf am Leithagebirge;10_14;197;108;89;2021
AT1;AT12;AT127;30716;Mannersdorf am Leithagebirge;15_19;202;95;107;2021
AT1;AT12;AT127;30716;Mannersdorf am Leithagebirge;20_24;228;121;107;2021
AT1;AT12;AT127;30716;Mannersdorf am Leithagebirge;25_29;226;111;115;2021
AT1;AT12;AT127;30716;Mannersdorf am Leithagebirge;30_34;260;140;120;2021
AT1;AT12;AT127;30716;Mannersdorf am Leithagebirge;35_39;286;136;150;2021
AT1;AT12;AT127;30716;Mannersdorf am Leithagebirge;40_44;259;133;126;2021
AT1;AT12;AT127;30716;Mannersdorf am Leithagebirge;45_49;302;151;151;2021
AT1;AT12;AT127;30716;Mannersdorf am Leithagebirge;50_54;322;158;164;2021
AT1;AT12;AT127;30716;Mannersdorf am Leithagebirge;55_59;343;164;179;2021
AT1;AT12;AT127;30716;Mannersdorf am Leithagebirge;60_64;280;150;130;2021
AT1;AT12;AT127;30716;Mannersdorf am Leithagebirge;65_69;212;100;112;2021
AT1;AT12;AT127;30716;Mannersdorf am Leithagebirge;70_74;214;101;113;2021
AT1;AT12;AT127;30716;Mannersdorf am Leithagebirge;75_79;122;62;60;2021
AT1;AT12;AT127;30716;Mannersdorf am Leithagebirge;80_84;133;54;79;2021
AT1;AT12;AT127;30716;Mannersdorf am Leithagebirge;85_89;68;26;42;2021
AT1;AT12;AT127;30716;Mannersdorf am Leithagebirge;90_94;36;8;28;2021
AT1;AT12;AT127;30716;Mannersdorf am Leithagebirge;95_;8;0;8;2021
AT1;AT12;AT127;30718;Petronell-Carnuntum;0_4;58;32;26;2021
AT1;AT12;AT127;30718;Petronell-Carnuntum;5_9;65;31;34;2021
AT1;AT12;AT127;30718;Petronell-Carnuntum;10_14;52;25;27;2021
AT1;AT12;AT127;30718;Petronell-Carnuntum;15_19;51;31;20;2021
AT1;AT12;AT127;30718;Petronell-Carnuntum;20_24;48;27;21;2021
AT1;AT12;AT127;30718;Petronell-Carnuntum;25_29;78;35;43;2021
AT1;AT12;AT127;30718;Petronell-Carnuntum;30_34;63;35;28;2021
AT1;AT12;AT127;30718;Petronell-Carnuntum;35_39;92;56;36;2021
AT1;AT12;AT127;30718;Petronell-Carnuntum;40_44;92;38;54;2021
AT1;AT12;AT127;30718;Petronell-Carnuntum;45_49;80;37;43;2021
AT1;AT12;AT127;30718;Petronell-Carnuntum;50_54;105;70;35;2021
AT1;AT12;AT127;30718;Petronell-Carnuntum;55_59;117;49;68;2021
AT1;AT12;AT127;30718;Petronell-Carnuntum;60_64;82;44;38;2021
AT1;AT12;AT127;30718;Petronell-Carnuntum;65_69;79;35;44;2021
AT1;AT12;AT127;30718;Petronell-Carnuntum;70_74;81;42;39;2021
AT1;AT12;AT127;30718;Petronell-Carnuntum;75_79;61;29;32;2021
AT1;AT12;AT127;30718;Petronell-Carnuntum;80_84;41;18;23;2021
AT1;AT12;AT127;30718;Petronell-Carnuntum;85_89;19;9;10;2021
AT1;AT12;AT127;30718;Petronell-Carnuntum;90_94;3;0;3;2021
AT1;AT12;AT127;30718;Petronell-Carnuntum;95_;2;0;2;2021
AT1;AT12;AT127;30719;Prellenkirchen;0_4;78;45;33;2021
AT1;AT12;AT127;30719;Prellenkirchen;5_9;91;45;46;2021
AT1;AT12;AT127;30719;Prellenkirchen;10_14;81;42;39;2021
AT1;AT12;AT127;30719;Prellenkirchen;15_19;62;30;32;2021
AT1;AT12;AT127;30719;Prellenkirchen;20_24;69;42;27;2021
AT1;AT12;AT127;30719;Prellenkirchen;25_29;73;34;39;2021
AT1;AT12;AT127;30719;Prellenkirchen;30_34;87;44;43;2021
AT1;AT12;AT127;30719;Prellenkirchen;35_39;131;66;65;2021
AT1;AT12;AT127;30719;Prellenkirchen;40_44;109;60;49;2021
AT1;AT12;AT127;30719;Prellenkirchen;45_49;105;49;56;2021
AT1;AT12;AT127;30719;Prellenkirchen;50_54;149;71;78;2021
AT1;AT12;AT127;30719;Prellenkirchen;55_59;134;73;61;2021
AT1;AT12;AT127;30719;Prellenkirchen;60_64;104;55;49;2021
AT1;AT12;AT127;30719;Prellenkirchen;65_69;90;44;46;2021
AT1;AT12;AT127;30719;Prellenkirchen;70_74;98;45;53;2021
AT1;AT12;AT127;30719;Prellenkirchen;75_79;71;38;33;2021
AT1;AT12;AT127;30719;Prellenkirchen;80_84;51;29;22;2021
AT1;AT12;AT127;30719;Prellenkirchen;85_89;28;13;15;2021
AT1;AT12;AT127;30719;Prellenkirchen;90_94;8;2;6;2021
AT1;AT12;AT127;30719;Prellenkirchen;95_;1;0;1;2021
AT1;AT12;AT127;30721;Rohrau;0_4;84;45;39;2021
AT1;AT12;AT127;30721;Rohrau;5_9;99;46;53;2021
AT1;AT12;AT127;30721;Rohrau;10_14;86;44;42;2021
AT1;AT12;AT127;30721;Rohrau;15_19;66;38;28;2021
AT1;AT12;AT127;30721;Rohrau;20_24;95;57;38;2021
AT1;AT12;AT127;30721;Rohrau;25_29;87;42;45;2021
AT1;AT12;AT127;30721;Rohrau;30_34;82;44;38;2021
AT1;AT12;AT127;30721;Rohrau;35_39;97;51;46;2021
AT1;AT12;AT127;30721;Rohrau;40_44;118;48;70;2021
AT1;AT12;AT127;30721;Rohrau;45_49;134;64;70;2021
AT1;AT12;AT127;30721;Rohrau;50_54;160;83;77;2021
AT1;AT12;AT127;30721;Rohrau;55_59;144;76;68;2021
AT1;AT12;AT127;30721;Rohrau;60_64;90;52;38;2021
AT1;AT12;AT127;30721;Rohrau;65_69;89;37;52;2021
AT1;AT12;AT127;30721;Rohrau;70_74;76;38;38;2021
AT1;AT12;AT127;30721;Rohrau;75_79;49;21;28;2021
AT1;AT12;AT127;30721;Rohrau;80_84;51;23;28;2021
AT1;AT12;AT127;30721;Rohrau;85_89;22;7;15;2021
AT1;AT12;AT127;30721;Rohrau;90_94;10;2;8;2021
AT1;AT12;AT127;30721;Rohrau;95_;0;0;0;2021
AT1;AT12;AT127;30722;Scharndorf;0_4;49;27;22;2021
AT1;AT12;AT127;30722;Scharndorf;5_9;61;37;24;2021
AT1;AT12;AT127;30722;Scharndorf;10_14;44;19;25;2021
AT1;AT12;AT127;30722;Scharndorf;15_19;61;38;23;2021
AT1;AT12;AT127;30722;Scharndorf;20_24;61;31;30;2021
AT1;AT12;AT127;30722;Scharndorf;25_29;48;22;26;2021
AT1;AT12;AT127;30722;Scharndorf;30_34;69;35;34;2021
AT1;AT12;AT127;30722;Scharndorf;35_39;73;39;34;2021
AT1;AT12;AT127;30722;Scharndorf;40_44;73;42;31;2021
AT1;AT12;AT127;30722;Scharndorf;45_49;82;37;45;2021
AT1;AT12;AT127;30722;Scharndorf;50_54;110;54;56;2021
AT1;AT12;AT127;30722;Scharndorf;55_59;126;72;54;2021
AT1;AT12;AT127;30722;Scharndorf;60_64;85;46;39;2021
AT1;AT12;AT127;30722;Scharndorf;65_69;63;29;34;2021
AT1;AT12;AT127;30722;Scharndorf;70_74;72;28;44;2021
AT1;AT12;AT127;30722;Scharndorf;75_79;51;27;24;2021
AT1;AT12;AT127;30722;Scharndorf;80_84;45;20;25;2021
AT1;AT12;AT127;30722;Scharndorf;85_89;24;11;13;2021
AT1;AT12;AT127;30722;Scharndorf;90_94;5;2;3;2021
AT1;AT12;AT127;30722;Scharndorf;95_;1;1;0;2021
AT1;AT12;AT127;30724;Sommerein;0_4;108;53;55;2021
AT1;AT12;AT127;30724;Sommerein;5_9;104;50;54;2021
AT1;AT12;AT127;30724;Sommerein;10_14;99;53;46;2021
AT1;AT12;AT127;30724;Sommerein;15_19;100;54;46;2021
AT1;AT12;AT127;30724;Sommerein;20_24;89;41;48;2021
AT1;AT12;AT127;30724;Sommerein;25_29;111;45;66;2021
AT1;AT12;AT127;30724;Sommerein;30_34;140;78;62;2021
AT1;AT12;AT127;30724;Sommerein;35_39;146;63;83;2021
AT1;AT12;AT127;30724;Sommerein;40_44;141;66;75;2021
AT1;AT12;AT127;30724;Sommerein;45_49;157;81;76;2021
AT1;AT12;AT127;30724;Sommerein;50_54;179;87;92;2021
AT1;AT12;AT127;30724;Sommerein;55_59;184;92;92;2021
AT1;AT12;AT127;30724;Sommerein;60_64;146;81;65;2021
AT1;AT12;AT127;30724;Sommerein;65_69;124;60;64;2021
AT1;AT12;AT127;30724;Sommerein;70_74;93;46;47;2021
AT1;AT12;AT127;30724;Sommerein;75_79;81;36;45;2021
AT1;AT12;AT127;30724;Sommerein;80_84;66;25;41;2021
AT1;AT12;AT127;30724;Sommerein;85_89;25;10;15;2021
AT1;AT12;AT127;30724;Sommerein;90_94;8;2;6;2021
AT1;AT12;AT127;30724;Sommerein;95_;2;0;2;2021
AT1;AT12;AT127;30726;Trautmannsdorf an der Leitha;0_4;137;74;63;2021
AT1;AT12;AT127;30726;Trautmannsdorf an der Leitha;5_9;133;64;69;2021
AT1;AT12;AT127;30726;Trautmannsdorf an der Leitha;10_14;145;69;76;2021
AT1;AT12;AT127;30726;Trautmannsdorf an der Leitha;15_19;144;68;76;2021
AT1;AT12;AT127;30726;Trautmannsdorf an der Leitha;20_24;122;67;55;2021
AT1;AT12;AT127;30726;Trautmannsdorf an der Leitha;25_29;166;92;74;2021
AT1;AT12;AT127;30726;Trautmannsdorf an der Leitha;30_34;174;89;85;2021
AT1;AT12;AT127;30726;Trautmannsdorf an der Leitha;35_39;203;101;102;2021
AT1;AT12;AT127;30726;Trautmannsdorf an der Leitha;40_44;197;88;109;2021
AT1;AT12;AT127;30726;Trautmannsdorf an der Leitha;45_49;238;123;115;2021
AT1;AT12;AT127;30726;Trautmannsdorf an der Leitha;50_54;246;125;121;2021
AT1;AT12;AT127;30726;Trautmannsdorf an der Leitha;55_59;241;130;111;2021
AT1;AT12;AT127;30726;Trautmannsdorf an der Leitha;60_64;225;103;122;2021
AT1;AT12;AT127;30726;Trautmannsdorf an der Leitha;65_69;182;85;97;2021
AT1;AT12;AT127;30726;Trautmannsdorf an der Leitha;70_74;155;84;71;2021
AT1;AT12;AT127;30726;Trautmannsdorf an der Leitha;75_79;118;54;64;2021
AT1;AT12;AT127;30726;Trautmannsdorf an der Leitha;80_84;111;56;55;2021
AT1;AT12;AT127;30726;Trautmannsdorf an der Leitha;85_89;43;18;25;2021
AT1;AT12;AT127;30726;Trautmannsdorf an der Leitha;90_94;20;4;16;2021
AT1;AT12;AT127;30726;Trautmannsdorf an der Leitha;95_;5;2;3;2021
AT1;AT12;AT127;30728;Wolfsthal;0_4;59;33;26;2021
AT1;AT12;AT127;30728;Wolfsthal;5_9;98;56;42;2021
AT1;AT12;AT127;30728;Wolfsthal;10_14;92;41;51;2021
AT1;AT12;AT127;30728;Wolfsthal;15_19;69;36;33;2021
AT1;AT12;AT127;30728;Wolfsthal;20_24;49;24;25;2021
AT1;AT12;AT127;30728;Wolfsthal;25_29;42;23;19;2021
AT1;AT12;AT127;30728;Wolfsthal;30_34;49;21;28;2021
AT1;AT12;AT127;30728;Wolfsthal;35_39;97;43;54;2021
AT1;AT12;AT127;30728;Wolfsthal;40_44;120;55;65;2021
AT1;AT12;AT127;30728;Wolfsthal;45_49;92;44;48;2021
AT1;AT12;AT127;30728;Wolfsthal;50_54;82;48;34;2021
AT1;AT12;AT127;30728;Wolfsthal;55_59;84;40;44;2021
AT1;AT12;AT127;30728;Wolfsthal;60_64;67;35;32;2021
AT1;AT12;AT127;30728;Wolfsthal;65_69;50;27;23;2021
AT1;AT12;AT127;30728;Wolfsthal;70_74;42;13;29;2021
AT1;AT12;AT127;30728;Wolfsthal;75_79;33;14;19;2021
AT1;AT12;AT127;30728;Wolfsthal;80_84;22;8;14;2021
AT1;AT12;AT127;30728;Wolfsthal;85_89;17;7;10;2021
AT1;AT12;AT127;30728;Wolfsthal;90_94;12;3;9;2021
AT1;AT12;AT127;30728;Wolfsthal;95_;0;0;0;2021
AT1;AT12;AT127;30729;Ebergassing;0_4;175;90;85;2021
AT1;AT12;AT127;30729;Ebergassing;5_9;209;105;104;2021
AT1;AT12;AT127;30729;Ebergassing;10_14;214;101;113;2021
AT1;AT12;AT127;30729;Ebergassing;15_19;221;111;110;2021
AT1;AT12;AT127;30729;Ebergassing;20_24;225;109;116;2021
AT1;AT12;AT127;30729;Ebergassing;25_29;220;112;108;2021
AT1;AT12;AT127;30729;Ebergassing;30_34;233;111;122;2021
AT1;AT12;AT127;30729;Ebergassing;35_39;268;135;133;2021
AT1;AT12;AT127;30729;Ebergassing;40_44;278;130;148;2021
AT1;AT12;AT127;30729;Ebergassing;45_49;284;149;135;2021
AT1;AT12;AT127;30729;Ebergassing;50_54;396;200;196;2021
AT1;AT12;AT127;30729;Ebergassing;55_59;356;189;167;2021
AT1;AT12;AT127;30729;Ebergassing;60_64;269;139;130;2021
AT1;AT12;AT127;30729;Ebergassing;65_69;180;86;94;2021
AT1;AT12;AT127;30729;Ebergassing;70_74;199;93;106;2021
AT1;AT12;AT127;30729;Ebergassing;75_79;146;71;75;2021
AT1;AT12;AT127;30729;Ebergassing;80_84;79;32;47;2021
AT1;AT12;AT127;30729;Ebergassing;85_89;28;9;19;2021
AT1;AT12;AT127;30729;Ebergassing;90_94;21;7;14;2021
AT1;AT12;AT127;30729;Ebergassing;95_;5;2;3;2021
AT1;AT12;AT127;30730;Fischamend;0_4;267;142;125;2021
AT1;AT12;AT127;30730;Fischamend;5_9;271;129;142;2021
AT1;AT12;AT127;30730;Fischamend;10_14;261;115;146;2021
AT1;AT12;AT127;30730;Fischamend;15_19;247;127;120;2021
AT1;AT12;AT127;30730;Fischamend;20_24;265;129;136;2021
AT1;AT12;AT127;30730;Fischamend;25_29;358;185;173;2021
AT1;AT12;AT127;30730;Fischamend;30_34;381;196;185;2021
AT1;AT12;AT127;30730;Fischamend;35_39;423;189;234;2021
AT1;AT12;AT127;30730;Fischamend;40_44;387;204;183;2021
AT1;AT12;AT127;30730;Fischamend;45_49;433;216;217;2021
AT1;AT12;AT127;30730;Fischamend;50_54;503;260;243;2021
AT1;AT12;AT127;30730;Fischamend;55_59;436;211;225;2021
AT1;AT12;AT127;30730;Fischamend;60_64;342;171;171;2021
AT1;AT12;AT127;30730;Fischamend;65_69;246;94;152;2021
AT1;AT12;AT127;30730;Fischamend;70_74;263;123;140;2021
AT1;AT12;AT127;30730;Fischamend;75_79;209;79;130;2021
AT1;AT12;AT127;30730;Fischamend;80_84;157;66;91;2021
AT1;AT12;AT127;30730;Fischamend;85_89;76;26;50;2021
AT1;AT12;AT127;30730;Fischamend;90_94;42;10;32;2021
AT1;AT12;AT127;30730;Fischamend;95_;11;4;7;2021
AT1;AT12;AT127;30731;Gramatneusiedl;0_4;245;119;126;2021
AT1;AT12;AT127;30731;Gramatneusiedl;5_9;220;113;107;2021
AT1;AT12;AT127;30731;Gramatneusiedl;10_14;231;109;122;2021
AT1;AT12;AT127;30731;Gramatneusiedl;15_19;202;103;99;2021
AT1;AT12;AT127;30731;Gramatneusiedl;20_24;170;84;86;2021
AT1;AT12;AT127;30731;Gramatneusiedl;25_29;209;111;98;2021
AT1;AT12;AT127;30731;Gramatneusiedl;30_34;295;137;158;2021
AT1;AT12;AT127;30731;Gramatneusiedl;35_39;282;134;148;2021
AT1;AT12;AT127;30731;Gramatneusiedl;40_44;305;150;155;2021
AT1;AT12;AT127;30731;Gramatneusiedl;45_49;285;145;140;2021
AT1;AT12;AT127;30731;Gramatneusiedl;50_54;275;150;125;2021
AT1;AT12;AT127;30731;Gramatneusiedl;55_59;266;126;140;2021
AT1;AT12;AT127;30731;Gramatneusiedl;60_64;180;85;95;2021
AT1;AT12;AT127;30731;Gramatneusiedl;65_69;138;67;71;2021
AT1;AT12;AT127;30731;Gramatneusiedl;70_74;134;72;62;2021
AT1;AT12;AT127;30731;Gramatneusiedl;75_79;94;41;53;2021
AT1;AT12;AT127;30731;Gramatneusiedl;80_84;70;32;38;2021
AT1;AT12;AT127;30731;Gramatneusiedl;85_89;24;9;15;2021
AT1;AT12;AT127;30731;Gramatneusiedl;90_94;12;5;7;2021
AT1;AT12;AT127;30731;Gramatneusiedl;95_;2;0;2;2021
AT1;AT12;AT127;30732;Himberg;0_4;358;186;172;2021
AT1;AT12;AT127;30732;Himberg;5_9;377;188;189;2021
AT1;AT12;AT127;30732;Himberg;10_14;410;223;187;2021
AT1;AT12;AT127;30732;Himberg;15_19;354;185;169;2021
AT1;AT12;AT127;30732;Himberg;20_24;335;195;140;2021
AT1;AT12;AT127;30732;Himberg;25_29;411;192;219;2021
AT1;AT12;AT127;30732;Himberg;30_34;463;216;247;2021
AT1;AT12;AT127;30732;Himberg;35_39;519;258;261;2021
AT1;AT12;AT127;30732;Himberg;40_44;541;263;278;2021
AT1;AT12;AT127;30732;Himberg;45_49;581;284;297;2021
AT1;AT12;AT127;30732;Himberg;50_54;665;341;324;2021
AT1;AT12;AT127;30732;Himberg;55_59;617;314;303;2021
AT1;AT12;AT127;30732;Himberg;60_64;444;225;219;2021
AT1;AT12;AT127;30732;Himberg;65_69;363;161;202;2021
AT1;AT12;AT127;30732;Himberg;70_74;320;145;175;2021
AT1;AT12;AT127;30732;Himberg;75_79;319;142;177;2021
AT1;AT12;AT127;30732;Himberg;80_84;269;124;145;2021
AT1;AT12;AT127;30732;Himberg;85_89;151;54;97;2021
AT1;AT12;AT127;30732;Himberg;90_94;58;15;43;2021
AT1;AT12;AT127;30732;Himberg;95_;14;2;12;2021
AT1;AT12;AT127;30733;Klein-Neusiedl;0_4;56;28;28;2021
AT1;AT12;AT127;30733;Klein-Neusiedl;5_9;51;30;21;2021
AT1;AT12;AT127;30733;Klein-Neusiedl;10_14;48;29;19;2021
AT1;AT12;AT127;30733;Klein-Neusiedl;15_19;40;24;16;2021
AT1;AT12;AT127;30733;Klein-Neusiedl;20_24;39;19;20;2021
AT1;AT12;AT127;30733;Klein-Neusiedl;25_29;52;17;35;2021
AT1;AT12;AT127;30733;Klein-Neusiedl;30_34;75;38;37;2021
AT1;AT12;AT127;30733;Klein-Neusiedl;35_39;78;38;40;2021
AT1;AT12;AT127;30733;Klein-Neusiedl;40_44;70;30;40;2021
AT1;AT12;AT127;30733;Klein-Neusiedl;45_49;61;30;31;2021
AT1;AT12;AT127;30733;Klein-Neusiedl;50_54;82;38;44;2021
AT1;AT12;AT127;30733;Klein-Neusiedl;55_59;70;34;36;2021
AT1;AT12;AT127;30733;Klein-Neusiedl;60_64;57;29;28;2021
AT1;AT12;AT127;30733;Klein-Neusiedl;65_69;47;25;22;2021
AT1;AT12;AT127;30733;Klein-Neusiedl;70_74;46;19;27;2021
AT1;AT12;AT127;30733;Klein-Neusiedl;75_79;43;21;22;2021
AT1;AT12;AT127;30733;Klein-Neusiedl;80_84;29;8;21;2021
AT1;AT12;AT127;30733;Klein-Neusiedl;85_89;10;4;6;2021
AT1;AT12;AT127;30733;Klein-Neusiedl;90_94;14;5;9;2021
AT1;AT12;AT127;30733;Klein-Neusiedl;95_;2;0;2;2021
AT1;AT12;AT127;30734;Lanzendorf;0_4;100;57;43;2021
AT1;AT12;AT127;30734;Lanzendorf;5_9;118;74;44;2021
AT1;AT12;AT127;30734;Lanzendorf;10_14;91;44;47;2021
AT1;AT12;AT127;30734;Lanzendorf;15_19;100;45;55;2021
AT1;AT12;AT127;30734;Lanzendorf;20_24;66;40;26;2021
AT1;AT12;AT127;30734;Lanzendorf;25_29;69;34;35;2021
AT1;AT12;AT127;30734;Lanzendorf;30_34;110;58;52;2021
AT1;AT12;AT127;30734;Lanzendorf;35_39;164;76;88;2021
AT1;AT12;AT127;30734;Lanzendorf;40_44;153;78;75;2021
AT1;AT12;AT127;30734;Lanzendorf;45_49;143;72;71;2021
AT1;AT12;AT127;30734;Lanzendorf;50_54;176;85;91;2021
AT1;AT12;AT127;30734;Lanzendorf;55_59;176;83;93;2021
AT1;AT12;AT127;30734;Lanzendorf;60_64;112;55;57;2021
AT1;AT12;AT127;30734;Lanzendorf;65_69;90;36;54;2021
AT1;AT12;AT127;30734;Lanzendorf;70_74;86;41;45;2021
AT1;AT12;AT127;30734;Lanzendorf;75_79;61;30;31;2021
AT1;AT12;AT127;30734;Lanzendorf;80_84;62;30;32;2021
AT1;AT12;AT127;30734;Lanzendorf;85_89;21;8;13;2021
AT1;AT12;AT127;30734;Lanzendorf;90_94;4;1;3;2021
AT1;AT12;AT127;30734;Lanzendorf;95_;3;0;3;2021
AT1;AT12;AT127;30735;Leopoldsdorf;0_4;236;109;127;2021
AT1;AT12;AT127;30735;Leopoldsdorf;5_9;280;145;135;2021
AT1;AT12;AT127;30735;Leopoldsdorf;10_14;255;133;122;2021
AT1;AT12;AT127;30735;Leopoldsdorf;15_19;300;163;137;2021
AT1;AT12;AT127;30735;Leopoldsdorf;20_24;298;168;130;2021
AT1;AT12;AT127;30735;Leopoldsdorf;25_29;245;124;121;2021
AT1;AT12;AT127;30735;Leopoldsdorf;30_34;292;152;140;2021
AT1;AT12;AT127;30735;Leopoldsdorf;35_39;378;181;197;2021
AT1;AT12;AT127;30735;Leopoldsdorf;40_44;365;179;186;2021
AT1;AT12;AT127;30735;Leopoldsdorf;45_49;398;187;211;2021
AT1;AT12;AT127;30735;Leopoldsdorf;50_54;533;260;273;2021
AT1;AT12;AT127;30735;Leopoldsdorf;55_59;462;220;242;2021
AT1;AT12;AT127;30735;Leopoldsdorf;60_64;338;158;180;2021
AT1;AT12;AT127;30735;Leopoldsdorf;65_69;229;118;111;2021
AT1;AT12;AT127;30735;Leopoldsdorf;70_74;217;100;117;2021
AT1;AT12;AT127;30735;Leopoldsdorf;75_79;214;102;112;2021
AT1;AT12;AT127;30735;Leopoldsdorf;80_84;128;64;64;2021
AT1;AT12;AT127;30735;Leopoldsdorf;85_89;58;20;38;2021
AT1;AT12;AT127;30735;Leopoldsdorf;90_94;21;7;14;2021
AT1;AT12;AT127;30735;Leopoldsdorf;95_;3;0;3;2021
AT1;AT12;AT127;30736;Maria-Lanzendorf;0_4;95;57;38;2021
AT1;AT12;AT127;30736;Maria-Lanzendorf;5_9;114;52;62;2021
AT1;AT12;AT127;30736;Maria-Lanzendorf;10_14;105;50;55;2021
AT1;AT12;AT127;30736;Maria-Lanzendorf;15_19;98;52;46;2021
AT1;AT12;AT127;30736;Maria-Lanzendorf;20_24;69;30;39;2021
AT1;AT12;AT127;30736;Maria-Lanzendorf;25_29;97;55;42;2021
AT1;AT12;AT127;30736;Maria-Lanzendorf;30_34;130;65;65;2021
AT1;AT12;AT127;30736;Maria-Lanzendorf;35_39;157;80;77;2021
AT1;AT12;AT127;30736;Maria-Lanzendorf;40_44;127;50;77;2021
AT1;AT12;AT127;30736;Maria-Lanzendorf;45_49;170;85;85;2021
AT1;AT12;AT127;30736;Maria-Lanzendorf;50_54;169;83;86;2021
AT1;AT12;AT127;30736;Maria-Lanzendorf;55_59;196;108;88;2021
AT1;AT12;AT127;30736;Maria-Lanzendorf;60_64;161;85;76;2021
AT1;AT12;AT127;30736;Maria-Lanzendorf;65_69;117;53;64;2021
AT1;AT12;AT127;30736;Maria-Lanzendorf;70_74;124;54;70;2021
AT1;AT12;AT127;30736;Maria-Lanzendorf;75_79;94;45;49;2021
AT1;AT12;AT127;30736;Maria-Lanzendorf;80_84;74;33;41;2021
AT1;AT12;AT127;30736;Maria-Lanzendorf;85_89;36;10;26;2021
AT1;AT12;AT127;30736;Maria-Lanzendorf;90_94;15;4;11;2021
AT1;AT12;AT127;30736;Maria-Lanzendorf;95_;8;2;6;2021
AT1;AT12;AT127;30737;Moosbrunn;0_4;89;54;35;2021
AT1;AT12;AT127;30737;Moosbrunn;5_9;106;49;57;2021
AT1;AT12;AT127;30737;Moosbrunn;10_14;76;34;42;2021
AT1;AT12;AT127;30737;Moosbrunn;15_19;65;31;34;2021
AT1;AT12;AT127;30737;Moosbrunn;20_24;74;41;33;2021
AT1;AT12;AT127;30737;Moosbrunn;25_29;101;50;51;2021
AT1;AT12;AT127;30737;Moosbrunn;30_34;105;46;59;2021
AT1;AT12;AT127;30737;Moosbrunn;35_39;137;62;75;2021
AT1;AT12;AT127;30737;Moosbrunn;40_44;125;63;62;2021
AT1;AT12;AT127;30737;Moosbrunn;45_49;121;68;53;2021
AT1;AT12;AT127;30737;Moosbrunn;50_54;158;84;74;2021
AT1;AT12;AT127;30737;Moosbrunn;55_59;149;76;73;2021
AT1;AT12;AT127;30737;Moosbrunn;60_64;129;61;68;2021
AT1;AT12;AT127;30737;Moosbrunn;65_69;99;44;55;2021
AT1;AT12;AT127;30737;Moosbrunn;70_74;90;43;47;2021
AT1;AT12;AT127;30737;Moosbrunn;75_79;63;30;33;2021
AT1;AT12;AT127;30737;Moosbrunn;80_84;58;27;31;2021
AT1;AT12;AT127;30737;Moosbrunn;85_89;21;10;11;2021
AT1;AT12;AT127;30737;Moosbrunn;90_94;10;4;6;2021
AT1;AT12;AT127;30737;Moosbrunn;95_;2;0;2;2021
AT1;AT12;AT127;30738;Rauchenwarth;0_4;60;31;29;2021
AT1;AT12;AT127;30738;Rauchenwarth;5_9;37;22;15;2021
AT1;AT12;AT127;30738;Rauchenwarth;10_14;37;14;23;2021
AT1;AT12;AT127;30738;Rauchenwarth;15_19;33;19;14;2021
AT1;AT12;AT127;30738;Rauchenwarth;20_24;38;16;22;2021
AT1;AT12;AT127;30738;Rauchenwarth;25_29;58;28;30;2021
AT1;AT12;AT127;30738;Rauchenwarth;30_34;65;31;34;2021
AT1;AT12;AT127;30738;Rauchenwarth;35_39;55;26;29;2021
AT1;AT12;AT127;30738;Rauchenwarth;40_44;42;23;19;2021
AT1;AT12;AT127;30738;Rauchenwarth;45_49;64;35;29;2021
AT1;AT12;AT127;30738;Rauchenwarth;50_54;68;32;36;2021
AT1;AT12;AT127;30738;Rauchenwarth;55_59;57;29;28;2021
AT1;AT12;AT127;30738;Rauchenwarth;60_64;46;26;20;2021
AT1;AT12;AT127;30738;Rauchenwarth;65_69;33;12;21;2021
AT1;AT12;AT127;30738;Rauchenwarth;70_74;19;12;7;2021
AT1;AT12;AT127;30738;Rauchenwarth;75_79;26;10;16;2021
AT1;AT12;AT127;30738;Rauchenwarth;80_84;17;8;9;2021
AT1;AT12;AT127;30738;Rauchenwarth;85_89;11;5;6;2021
AT1;AT12;AT127;30738;Rauchenwarth;90_94;9;4;5;2021
AT1;AT12;AT127;30738;Rauchenwarth;95_;0;0;0;2021
AT1;AT12;AT127;30739;Schwadorf;0_4;126;59;67;2021
AT1;AT12;AT127;30739;Schwadorf;5_9;100;42;58;2021
AT1;AT12;AT127;30739;Schwadorf;10_14;126;67;59;2021
AT1;AT12;AT127;30739;Schwadorf;15_19;120;60;60;2021
AT1;AT12;AT127;30739;Schwadorf;20_24;131;72;59;2021
AT1;AT12;AT127;30739;Schwadorf;25_29;172;84;88;2021
AT1;AT12;AT127;30739;Schwadorf;30_34;152;75;77;2021
AT1;AT12;AT127;30739;Schwadorf;35_39;156;77;79;2021
AT1;AT12;AT127;30739;Schwadorf;40_44;156;85;71;2021
AT1;AT12;AT127;30739;Schwadorf;45_49;151;66;85;2021
AT1;AT12;AT127;30739;Schwadorf;50_54;172;85;87;2021
AT1;AT12;AT127;30739;Schwadorf;55_59;169;95;74;2021
AT1;AT12;AT127;30739;Schwadorf;60_64;145;63;82;2021
AT1;AT12;AT127;30739;Schwadorf;65_69;89;44;45;2021
AT1;AT12;AT127;30739;Schwadorf;70_74;94;44;50;2021
AT1;AT12;AT127;30739;Schwadorf;75_79;59;30;29;2021
AT1;AT12;AT127;30739;Schwadorf;80_84;51;19;32;2021
AT1;AT12;AT127;30739;Schwadorf;85_89;32;14;18;2021
AT1;AT12;AT127;30739;Schwadorf;90_94;14;5;9;2021
AT1;AT12;AT127;30739;Schwadorf;95_;5;3;2;2021
AT1;AT12;AT127;30740;Schwechat;0_4;1039;533;506;2021
AT1;AT12;AT127;30740;Schwechat;5_9;972;540;432;2021
AT1;AT12;AT127;30740;Schwechat;10_14;933;520;413;2021
AT1;AT12;AT127;30740;Schwechat;15_19;971;487;484;2021
AT1;AT12;AT127;30740;Schwechat;20_24;1158;622;536;2021
AT1;AT12;AT127;30740;Schwechat;25_29;1511;771;740;2021
AT1;AT12;AT127;30740;Schwechat;30_34;1616;851;765;2021
AT1;AT12;AT127;30740;Schwechat;35_39;1584;807;777;2021
AT1;AT12;AT127;30740;Schwechat;40_44;1376;697;679;2021
AT1;AT12;AT127;30740;Schwechat;45_49;1530;781;749;2021
AT1;AT12;AT127;30740;Schwechat;50_54;1656;811;845;2021
AT1;AT12;AT127;30740;Schwechat;55_59;1452;705;747;2021
AT1;AT12;AT127;30740;Schwechat;60_64;1113;541;572;2021
AT1;AT12;AT127;30740;Schwechat;65_69;917;398;519;2021
AT1;AT12;AT127;30740;Schwechat;70_74;945;416;529;2021
AT1;AT12;AT127;30740;Schwechat;75_79;714;296;418;2021
AT1;AT12;AT127;30740;Schwechat;80_84;536;223;313;2021
AT1;AT12;AT127;30740;Schwechat;85_89;222;72;150;2021
AT1;AT12;AT127;30740;Schwechat;90_94;101;35;66;2021
AT1;AT12;AT127;30740;Schwechat;95_;29;8;21;2021
AT1;AT12;AT127;30741;Zw�lfaxing;0_4;85;44;41;2021
AT1;AT12;AT127;30741;Zw�lfaxing;5_9;78;45;33;2021
AT1;AT12;AT127;30741;Zw�lfaxing;10_14;101;51;50;2021
AT1;AT12;AT127;30741;Zw�lfaxing;15_19;93;38;55;2021
AT1;AT12;AT127;30741;Zw�lfaxing;20_24;74;35;39;2021
AT1;AT12;AT127;30741;Zw�lfaxing;25_29;94;46;48;2021
AT1;AT12;AT127;30741;Zw�lfaxing;30_34;105;63;42;2021
AT1;AT12;AT127;30741;Zw�lfaxing;35_39;120;59;61;2021
AT1;AT12;AT127;30741;Zw�lfaxing;40_44;97;45;52;2021
AT1;AT12;AT127;30741;Zw�lfaxing;45_49;137;61;76;2021
AT1;AT12;AT127;30741;Zw�lfaxing;50_54;162;92;70;2021
AT1;AT12;AT127;30741;Zw�lfaxing;55_59;156;81;75;2021
AT1;AT12;AT127;30741;Zw�lfaxing;60_64;110;50;60;2021
AT1;AT12;AT127;30741;Zw�lfaxing;65_69;87;47;40;2021
AT1;AT12;AT127;30741;Zw�lfaxing;70_74;76;38;38;2021
AT1;AT12;AT127;30741;Zw�lfaxing;75_79;68;37;31;2021
AT1;AT12;AT127;30741;Zw�lfaxing;80_84;56;26;30;2021
AT1;AT12;AT127;30741;Zw�lfaxing;85_89;31;17;14;2021
AT1;AT12;AT127;30741;Zw�lfaxing;90_94;12;4;8;2021
AT1;AT12;AT127;30741;Zw�lfaxing;95_;1;0;1;2021
AT1;AT12;AT126;30801;Aderklaa;0_4;9;5;4;2021
AT1;AT12;AT126;30801;Aderklaa;5_9;5;2;3;2021
AT1;AT12;AT126;30801;Aderklaa;10_14;14;9;5;2021
AT1;AT12;AT126;30801;Aderklaa;15_19;9;4;5;2021
AT1;AT12;AT126;30801;Aderklaa;20_24;12;5;7;2021
AT1;AT12;AT126;30801;Aderklaa;25_29;14;8;6;2021
AT1;AT12;AT126;30801;Aderklaa;30_34;11;7;4;2021
AT1;AT12;AT126;30801;Aderklaa;35_39;19;9;10;2021
AT1;AT12;AT126;30801;Aderklaa;40_44;10;7;3;2021
AT1;AT12;AT126;30801;Aderklaa;45_49;18;11;7;2021
AT1;AT12;AT126;30801;Aderklaa;50_54;14;7;7;2021
AT1;AT12;AT126;30801;Aderklaa;55_59;15;8;7;2021
AT1;AT12;AT126;30801;Aderklaa;60_64;15;9;6;2021
AT1;AT12;AT126;30801;Aderklaa;65_69;14;10;4;2021
AT1;AT12;AT126;30801;Aderklaa;70_74;7;3;4;2021
AT1;AT12;AT126;30801;Aderklaa;75_79;6;3;3;2021
AT1;AT12;AT126;30801;Aderklaa;80_84;2;1;1;2021
AT1;AT12;AT126;30801;Aderklaa;85_89;4;2;2;2021
AT1;AT12;AT126;30801;Aderklaa;90_94;0;0;0;2021
AT1;AT12;AT126;30801;Aderklaa;95_;0;0;0;2021
AT1;AT12;AT126;30802;Andlersdorf;0_4;5;3;2;2021
AT1;AT12;AT126;30802;Andlersdorf;5_9;8;5;3;2021
AT1;AT12;AT126;30802;Andlersdorf;10_14;9;1;8;2021
AT1;AT12;AT126;30802;Andlersdorf;15_19;5;3;2;2021
AT1;AT12;AT126;30802;Andlersdorf;20_24;5;4;1;2021
AT1;AT12;AT126;30802;Andlersdorf;25_29;1;1;0;2021
AT1;AT12;AT126;30802;Andlersdorf;30_34;5;4;1;2021
AT1;AT12;AT126;30802;Andlersdorf;35_39;7;4;3;2021
AT1;AT12;AT126;30802;Andlersdorf;40_44;12;6;6;2021
AT1;AT12;AT126;30802;Andlersdorf;45_49;7;2;5;2021
AT1;AT12;AT126;30802;Andlersdorf;50_54;6;4;2;2021
AT1;AT12;AT126;30802;Andlersdorf;55_59;9;4;5;2021
AT1;AT12;AT126;30802;Andlersdorf;60_64;16;3;13;2021
AT1;AT12;AT126;30802;Andlersdorf;65_69;11;6;5;2021
AT1;AT12;AT126;30802;Andlersdorf;70_74;4;4;0;2021
AT1;AT12;AT126;30802;Andlersdorf;75_79;6;2;4;2021
AT1;AT12;AT126;30802;Andlersdorf;80_84;6;3;3;2021
AT1;AT12;AT126;30802;Andlersdorf;85_89;2;0;2;2021
AT1;AT12;AT126;30802;Andlersdorf;90_94;1;1;0;2021
AT1;AT12;AT126;30802;Andlersdorf;95_;2;0;2;2021
AT1;AT12;AT126;30803;Angern an der March;0_4;147;75;72;2021
AT1;AT12;AT126;30803;Angern an der March;5_9;183;100;83;2021
AT1;AT12;AT126;30803;Angern an der March;10_14;160;85;75;2021
AT1;AT12;AT126;30803;Angern an der March;15_19;174;89;85;2021
AT1;AT12;AT126;30803;Angern an der March;20_24;171;86;85;2021
AT1;AT12;AT126;30803;Angern an der March;25_29;191;98;93;2021
AT1;AT12;AT126;30803;Angern an der March;30_34;225;105;120;2021
AT1;AT12;AT126;30803;Angern an der March;35_39;194;106;88;2021
AT1;AT12;AT126;30803;Angern an der March;40_44;180;85;95;2021
AT1;AT12;AT126;30803;Angern an der March;45_49;234;111;123;2021
AT1;AT12;AT126;30803;Angern an der March;50_54;285;139;146;2021
AT1;AT12;AT126;30803;Angern an der March;55_59;347;177;170;2021
AT1;AT12;AT126;30803;Angern an der March;60_64;232;122;110;2021
AT1;AT12;AT126;30803;Angern an der March;65_69;186;93;93;2021
AT1;AT12;AT126;30803;Angern an der March;70_74;183;94;89;2021
AT1;AT12;AT126;30803;Angern an der March;75_79;134;58;76;2021
AT1;AT12;AT126;30803;Angern an der March;80_84;111;48;63;2021
AT1;AT12;AT126;30803;Angern an der March;85_89;65;19;46;2021
AT1;AT12;AT126;30803;Angern an der March;90_94;29;8;21;2021
AT1;AT12;AT126;30803;Angern an der March;95_;5;0;5;2021
AT1;AT12;AT126;30804;Auersthal;0_4;85;50;35;2021
AT1;AT12;AT126;30804;Auersthal;5_9;107;57;50;2021
AT1;AT12;AT126;30804;Auersthal;10_14;87;45;42;2021
AT1;AT12;AT126;30804;Auersthal;15_19;88;46;42;2021
AT1;AT12;AT126;30804;Auersthal;20_24;82;53;29;2021
AT1;AT12;AT126;30804;Auersthal;25_29;135;63;72;2021
AT1;AT12;AT126;30804;Auersthal;30_34;134;77;57;2021
AT1;AT12;AT126;30804;Auersthal;35_39;114;59;55;2021
AT1;AT12;AT126;30804;Auersthal;40_44;109;53;56;2021
AT1;AT12;AT126;30804;Auersthal;45_49;137;68;69;2021
AT1;AT12;AT126;30804;Auersthal;50_54;156;70;86;2021
AT1;AT12;AT126;30804;Auersthal;55_59;164;95;69;2021
AT1;AT12;AT126;30804;Auersthal;60_64;140;74;66;2021
AT1;AT12;AT126;30804;Auersthal;65_69;112;42;70;2021
AT1;AT12;AT126;30804;Auersthal;70_74;86;41;45;2021
AT1;AT12;AT126;30804;Auersthal;75_79;60;24;36;2021
AT1;AT12;AT126;30804;Auersthal;80_84;75;35;40;2021
AT1;AT12;AT126;30804;Auersthal;85_89;43;15;28;2021
AT1;AT12;AT126;30804;Auersthal;90_94;13;3;10;2021
AT1;AT12;AT126;30804;Auersthal;95_;3;0;3;2021
AT1;AT12;AT126;30805;Bad Pirawarth;0_4;97;52;45;2021
AT1;AT12;AT126;30805;Bad Pirawarth;5_9;102;47;55;2021
AT1;AT12;AT126;30805;Bad Pirawarth;10_14;91;52;39;2021
AT1;AT12;AT126;30805;Bad Pirawarth;15_19;75;44;31;2021
AT1;AT12;AT126;30805;Bad Pirawarth;20_24;65;37;28;2021
AT1;AT12;AT126;30805;Bad Pirawarth;25_29;99;52;47;2021
AT1;AT12;AT126;30805;Bad Pirawarth;30_34;102;49;53;2021
AT1;AT12;AT126;30805;Bad Pirawarth;35_39;120;60;60;2021
AT1;AT12;AT126;30805;Bad Pirawarth;40_44;123;58;65;2021
AT1;AT12;AT126;30805;Bad Pirawarth;45_49;118;58;60;2021
AT1;AT12;AT126;30805;Bad Pirawarth;50_54;137;67;70;2021
AT1;AT12;AT126;30805;Bad Pirawarth;55_59;136;69;67;2021
AT1;AT12;AT126;30805;Bad Pirawarth;60_64;139;67;72;2021
AT1;AT12;AT126;30805;Bad Pirawarth;65_69;113;57;56;2021
AT1;AT12;AT126;30805;Bad Pirawarth;70_74;101;47;54;2021
AT1;AT12;AT126;30805;Bad Pirawarth;75_79;47;24;23;2021
AT1;AT12;AT126;30805;Bad Pirawarth;80_84;64;27;37;2021
AT1;AT12;AT126;30805;Bad Pirawarth;85_89;26;9;17;2021
AT1;AT12;AT126;30805;Bad Pirawarth;90_94;15;7;8;2021
AT1;AT12;AT126;30805;Bad Pirawarth;95_;4;2;2;2021
AT1;AT12;AT126;30808;Deutsch-Wagram;0_4;471;222;249;2021
AT1;AT12;AT126;30808;Deutsch-Wagram;5_9;417;220;197;2021
AT1;AT12;AT126;30808;Deutsch-Wagram;10_14;460;232;228;2021
AT1;AT12;AT126;30808;Deutsch-Wagram;15_19;515;275;240;2021
AT1;AT12;AT126;30808;Deutsch-Wagram;20_24;511;261;250;2021
AT1;AT12;AT126;30808;Deutsch-Wagram;25_29;549;261;288;2021
AT1;AT12;AT126;30808;Deutsch-Wagram;30_34;613;313;300;2021
AT1;AT12;AT126;30808;Deutsch-Wagram;35_39;632;309;323;2021
AT1;AT12;AT126;30808;Deutsch-Wagram;40_44;532;256;276;2021
AT1;AT12;AT126;30808;Deutsch-Wagram;45_49;650;316;334;2021
AT1;AT12;AT126;30808;Deutsch-Wagram;50_54;766;384;382;2021
AT1;AT12;AT126;30808;Deutsch-Wagram;55_59;709;342;367;2021
AT1;AT12;AT126;30808;Deutsch-Wagram;60_64;568;280;288;2021
AT1;AT12;AT126;30808;Deutsch-Wagram;65_69;452;227;225;2021
AT1;AT12;AT126;30808;Deutsch-Wagram;70_74;409;175;234;2021
AT1;AT12;AT126;30808;Deutsch-Wagram;75_79;349;152;197;2021
AT1;AT12;AT126;30808;Deutsch-Wagram;80_84;260;117;143;2021
AT1;AT12;AT126;30808;Deutsch-Wagram;85_89;96;36;60;2021
AT1;AT12;AT126;30808;Deutsch-Wagram;90_94;51;15;36;2021
AT1;AT12;AT126;30808;Deutsch-Wagram;95_;8;2;6;2021
AT1;AT12;AT125;30810;Dr�sing;0_4;51;26;25;2021
AT1;AT12;AT125;30810;Dr�sing;5_9;45;20;25;2021
AT1;AT12;AT125;30810;Dr�sing;10_14;43;30;13;2021
AT1;AT12;AT125;30810;Dr�sing;15_19;32;16;16;2021
AT1;AT12;AT125;30810;Dr�sing;20_24;46;23;23;2021
AT1;AT12;AT125;30810;Dr�sing;25_29;59;26;33;2021
AT1;AT12;AT125;30810;Dr�sing;30_34;75;32;43;2021
AT1;AT12;AT125;30810;Dr�sing;35_39;72;40;32;2021
AT1;AT12;AT125;30810;Dr�sing;40_44;56;32;24;2021
AT1;AT12;AT125;30810;Dr�sing;45_49;54;26;28;2021
AT1;AT12;AT125;30810;Dr�sing;50_54;77;35;42;2021
AT1;AT12;AT125;30810;Dr�sing;55_59;124;63;61;2021
AT1;AT12;AT125;30810;Dr�sing;60_64;107;47;60;2021
AT1;AT12;AT125;30810;Dr�sing;65_69;70;32;38;2021
AT1;AT12;AT125;30810;Dr�sing;70_74;60;36;24;2021
AT1;AT12;AT125;30810;Dr�sing;75_79;48;21;27;2021
AT1;AT12;AT125;30810;Dr�sing;80_84;47;19;28;2021
AT1;AT12;AT125;30810;Dr�sing;85_89;25;7;18;2021
AT1;AT12;AT125;30810;Dr�sing;90_94;12;5;7;2021
AT1;AT12;AT125;30810;Dr�sing;95_;3;0;3;2021
AT1;AT12;AT125;30811;D�rnkrut;0_4;84;47;37;2021
AT1;AT12;AT125;30811;D�rnkrut;5_9;116;55;61;2021
AT1;AT12;AT125;30811;D�rnkrut;10_14;114;55;59;2021
AT1;AT12;AT125;30811;D�rnkrut;15_19;125;49;76;2021
AT1;AT12;AT125;30811;D�rnkrut;20_24;86;48;38;2021
AT1;AT12;AT125;30811;D�rnkrut;25_29;99;45;54;2021
AT1;AT12;AT125;30811;D�rnkrut;30_34;129;68;61;2021
AT1;AT12;AT125;30811;D�rnkrut;35_39;151;78;73;2021
AT1;AT12;AT125;30811;D�rnkrut;40_44;152;69;83;2021
AT1;AT12;AT125;30811;D�rnkrut;45_49;169;83;86;2021
AT1;AT12;AT125;30811;D�rnkrut;50_54;196;107;89;2021
AT1;AT12;AT125;30811;D�rnkrut;55_59;173;83;90;2021
AT1;AT12;AT125;30811;D�rnkrut;60_64;157;77;80;2021
AT1;AT12;AT125;30811;D�rnkrut;65_69;151;72;79;2021
AT1;AT12;AT125;30811;D�rnkrut;70_74;121;64;57;2021
AT1;AT12;AT125;30811;D�rnkrut;75_79;100;52;48;2021
AT1;AT12;AT125;30811;D�rnkrut;80_84;80;32;48;2021
AT1;AT12;AT125;30811;D�rnkrut;85_89;31;12;19;2021
AT1;AT12;AT125;30811;D�rnkrut;90_94;14;3;11;2021
AT1;AT12;AT125;30811;D�rnkrut;95_;2;0;2;2021
AT1;AT12;AT126;30812;Ebenthal;0_4;49;29;20;2021
AT1;AT12;AT126;30812;Ebenthal;5_9;50;31;19;2021
AT1;AT12;AT126;30812;Ebenthal;10_14;42;20;22;2021
AT1;AT12;AT126;30812;Ebenthal;15_19;49;31;18;2021
AT1;AT12;AT126;30812;Ebenthal;20_24;23;11;12;2021
AT1;AT12;AT126;30812;Ebenthal;25_29;44;19;25;2021
AT1;AT12;AT126;30812;Ebenthal;30_34;58;33;25;2021
AT1;AT12;AT126;30812;Ebenthal;35_39;70;28;42;2021
AT1;AT12;AT126;30812;Ebenthal;40_44;55;34;21;2021
AT1;AT12;AT126;30812;Ebenthal;45_49;61;33;28;2021
AT1;AT12;AT126;30812;Ebenthal;50_54;76;42;34;2021
AT1;AT12;AT126;30812;Ebenthal;55_59;89;46;43;2021
AT1;AT12;AT126;30812;Ebenthal;60_64;84;44;40;2021
AT1;AT12;AT126;30812;Ebenthal;65_69;35;16;19;2021
AT1;AT12;AT126;30812;Ebenthal;70_74;29;14;15;2021
AT1;AT12;AT126;30812;Ebenthal;75_79;33;16;17;2021
AT1;AT12;AT126;30812;Ebenthal;80_84;40;20;20;2021
AT1;AT12;AT126;30812;Ebenthal;85_89;14;4;10;2021
AT1;AT12;AT126;30812;Ebenthal;90_94;2;1;1;2021
AT1;AT12;AT126;30812;Ebenthal;95_;0;0;0;2021
AT1;AT12;AT126;30813;Eckartsau;0_4;73;41;32;2021
AT1;AT12;AT126;30813;Eckartsau;5_9;67;31;36;2021
AT1;AT12;AT126;30813;Eckartsau;10_14;60;31;29;2021
AT1;AT12;AT126;30813;Eckartsau;15_19;52;27;25;2021
AT1;AT12;AT126;30813;Eckartsau;20_24;66;31;35;2021
AT1;AT12;AT126;30813;Eckartsau;25_29;67;40;27;2021
AT1;AT12;AT126;30813;Eckartsau;30_34;102;58;44;2021
AT1;AT12;AT126;30813;Eckartsau;35_39;111;48;63;2021
AT1;AT12;AT126;30813;Eckartsau;40_44;72;37;35;2021
AT1;AT12;AT126;30813;Eckartsau;45_49;73;34;39;2021
AT1;AT12;AT126;30813;Eckartsau;50_54;116;59;57;2021
AT1;AT12;AT126;30813;Eckartsau;55_59;111;59;52;2021
AT1;AT12;AT126;30813;Eckartsau;60_64;108;63;45;2021
AT1;AT12;AT126;30813;Eckartsau;65_69;75;37;38;2021
AT1;AT12;AT126;30813;Eckartsau;70_74;63;32;31;2021
AT1;AT12;AT126;30813;Eckartsau;75_79;66;34;32;2021
AT1;AT12;AT126;30813;Eckartsau;80_84;40;17;23;2021
AT1;AT12;AT126;30813;Eckartsau;85_89;18;4;14;2021
AT1;AT12;AT126;30813;Eckartsau;90_94;13;3;10;2021
AT1;AT12;AT126;30813;Eckartsau;95_;0;0;0;2021
AT1;AT12;AT126;30814;Engelhartstetten;0_4;125;55;70;2021
AT1;AT12;AT126;30814;Engelhartstetten;5_9;113;57;56;2021
AT1;AT12;AT126;30814;Engelhartstetten;10_14;99;43;56;2021
AT1;AT12;AT126;30814;Engelhartstetten;15_19;85;49;36;2021
AT1;AT12;AT126;30814;Engelhartstetten;20_24;92;46;46;2021
AT1;AT12;AT126;30814;Engelhartstetten;25_29;115;59;56;2021
AT1;AT12;AT126;30814;Engelhartstetten;30_34;116;47;69;2021
AT1;AT12;AT126;30814;Engelhartstetten;35_39;132;67;65;2021
AT1;AT12;AT126;30814;Engelhartstetten;40_44;132;63;69;2021
AT1;AT12;AT126;30814;Engelhartstetten;45_49;142;74;68;2021
AT1;AT12;AT126;30814;Engelhartstetten;50_54;180;100;80;2021
AT1;AT12;AT126;30814;Engelhartstetten;55_59;179;93;86;2021
AT1;AT12;AT126;30814;Engelhartstetten;60_64;165;87;78;2021
AT1;AT12;AT126;30814;Engelhartstetten;65_69;139;73;66;2021
AT1;AT12;AT126;30814;Engelhartstetten;70_74;85;34;51;2021
AT1;AT12;AT126;30814;Engelhartstetten;75_79;77;40;37;2021
AT1;AT12;AT126;30814;Engelhartstetten;80_84;66;25;41;2021
AT1;AT12;AT126;30814;Engelhartstetten;85_89;34;13;21;2021
AT1;AT12;AT126;30814;Engelhartstetten;90_94;14;5;9;2021
AT1;AT12;AT126;30814;Engelhartstetten;95_;3;0;3;2021
AT1;AT12;AT126;30817;G�nserndorf;0_4;616;325;291;2021
AT1;AT12;AT126;30817;G�nserndorf;5_9;692;353;339;2021
AT1;AT12;AT126;30817;G�nserndorf;10_14;651;317;334;2021
AT1;AT12;AT126;30817;G�nserndorf;15_19;659;335;324;2021
AT1;AT12;AT126;30817;G�nserndorf;20_24;616;296;320;2021
AT1;AT12;AT126;30817;G�nserndorf;25_29;768;367;401;2021
AT1;AT12;AT126;30817;G�nserndorf;30_34;826;390;436;2021
AT1;AT12;AT126;30817;G�nserndorf;35_39;841;430;411;2021
AT1;AT12;AT126;30817;G�nserndorf;40_44;807;406;401;2021
AT1;AT12;AT126;30817;G�nserndorf;45_49;804;376;428;2021
AT1;AT12;AT126;30817;G�nserndorf;50_54;932;452;480;2021
AT1;AT12;AT126;30817;G�nserndorf;55_59;906;452;454;2021
AT1;AT12;AT126;30817;G�nserndorf;60_64;708;325;383;2021
AT1;AT12;AT126;30817;G�nserndorf;65_69;554;257;297;2021
AT1;AT12;AT126;30817;G�nserndorf;70_74;510;243;267;2021
AT1;AT12;AT126;30817;G�nserndorf;75_79;402;187;215;2021
AT1;AT12;AT126;30817;G�nserndorf;80_84;299;123;176;2021
AT1;AT12;AT126;30817;G�nserndorf;85_89;143;61;82;2021
AT1;AT12;AT126;30817;G�nserndorf;90_94;73;15;58;2021
AT1;AT12;AT126;30817;G�nserndorf;95_;25;4;21;2021
AT1;AT12;AT126;30819;Glinzendorf;0_4;15;8;7;2021
AT1;AT12;AT126;30819;Glinzendorf;5_9;18;10;8;2021
AT1;AT12;AT126;30819;Glinzendorf;10_14;24;13;11;2021
AT1;AT12;AT126;30819;Glinzendorf;15_19;19;6;13;2021
AT1;AT12;AT126;30819;Glinzendorf;20_24;16;9;7;2021
AT1;AT12;AT126;30819;Glinzendorf;25_29;10;5;5;2021
AT1;AT12;AT126;30819;Glinzendorf;30_34;27;11;16;2021
AT1;AT12;AT126;30819;Glinzendorf;35_39;20;13;7;2021
AT1;AT12;AT126;30819;Glinzendorf;40_44;27;13;14;2021
AT1;AT12;AT126;30819;Glinzendorf;45_49;29;14;15;2021
AT1;AT12;AT126;30819;Glinzendorf;50_54;29;15;14;2021
AT1;AT12;AT126;30819;Glinzendorf;55_59;26;13;13;2021
AT1;AT12;AT126;30819;Glinzendorf;60_64;19;10;9;2021
AT1;AT12;AT126;30819;Glinzendorf;65_69;13;7;6;2021
AT1;AT12;AT126;30819;Glinzendorf;70_74;10;4;6;2021
AT1;AT12;AT126;30819;Glinzendorf;75_79;10;4;6;2021
AT1;AT12;AT126;30819;Glinzendorf;80_84;10;3;7;2021
AT1;AT12;AT126;30819;Glinzendorf;85_89;7;5;2;2021
AT1;AT12;AT126;30819;Glinzendorf;90_94;0;0;0;2021
AT1;AT12;AT126;30819;Glinzendorf;95_;0;0;0;2021
AT1;AT12;AT126;30821;Gro�-Enzersdorf;0_4;575;270;305;2021
AT1;AT12;AT126;30821;Gro�-Enzersdorf;5_9;667;323;344;2021
AT1;AT12;AT126;30821;Gro�-Enzersdorf;10_14;653;331;322;2021
AT1;AT12;AT126;30821;Gro�-Enzersdorf;15_19;645;319;326;2021
AT1;AT12;AT126;30821;Gro�-Enzersdorf;20_24;574;288;286;2021
AT1;AT12;AT126;30821;Gro�-Enzersdorf;25_29;567;283;284;2021
AT1;AT12;AT126;30821;Gro�-Enzersdorf;30_34;726;347;379;2021
AT1;AT12;AT126;30821;Gro�-Enzersdorf;35_39;849;423;426;2021
AT1;AT12;AT126;30821;Gro�-Enzersdorf;40_44;807;405;402;2021
AT1;AT12;AT126;30821;Gro�-Enzersdorf;45_49;871;400;471;2021
AT1;AT12;AT126;30821;Gro�-Enzersdorf;50_54;1070;536;534;2021
AT1;AT12;AT126;30821;Gro�-Enzersdorf;55_59;939;479;460;2021
AT1;AT12;AT126;30821;Gro�-Enzersdorf;60_64;766;380;386;2021
AT1;AT12;AT126;30821;Gro�-Enzersdorf;65_69;532;254;278;2021
AT1;AT12;AT126;30821;Gro�-Enzersdorf;70_74;549;240;309;2021
AT1;AT12;AT126;30821;Gro�-Enzersdorf;75_79;477;232;245;2021
AT1;AT12;AT126;30821;Gro�-Enzersdorf;80_84;274;117;157;2021
AT1;AT12;AT126;30821;Gro�-Enzersdorf;85_89;150;64;86;2021
AT1;AT12;AT126;30821;Gro�-Enzersdorf;90_94;42;16;26;2021
AT1;AT12;AT126;30821;Gro�-Enzersdorf;95_;7;1;6;2021
AT1;AT12;AT126;30822;Gro�hofen;0_4;6;3;3;2021
AT1;AT12;AT126;30822;Gro�hofen;5_9;7;5;2;2021
AT1;AT12;AT126;30822;Gro�hofen;10_14;9;5;4;2021
AT1;AT12;AT126;30822;Gro�hofen;15_19;4;2;2;2021
AT1;AT12;AT126;30822;Gro�hofen;20_24;3;1;2;2021
AT1;AT12;AT126;30822;Gro�hofen;25_29;6;3;3;2021
AT1;AT12;AT126;30822;Gro�hofen;30_34;7;3;4;2021
AT1;AT12;AT126;30822;Gro�hofen;35_39;9;6;3;2021
AT1;AT12;AT126;30822;Gro�hofen;40_44;7;3;4;2021
AT1;AT12;AT126;30822;Gro�hofen;45_49;6;3;3;2021
AT1;AT12;AT126;30822;Gro�hofen;50_54;9;5;4;2021
AT1;AT12;AT126;30822;Gro�hofen;55_59;10;4;6;2021
AT1;AT12;AT126;30822;Gro�hofen;60_64;6;5;1;2021
AT1;AT12;AT126;30822;Gro�hofen;65_69;2;2;0;2021
AT1;AT12;AT126;30822;Gro�hofen;70_74;2;1;1;2021
AT1;AT12;AT126;30822;Gro�hofen;75_79;7;3;4;2021
AT1;AT12;AT126;30822;Gro�hofen;80_84;2;1;1;2021
AT1;AT12;AT126;30822;Gro�hofen;85_89;3;1;2;2021
AT1;AT12;AT126;30822;Gro�hofen;90_94;0;0;0;2021
AT1;AT12;AT126;30822;Gro�hofen;95_;1;0;1;2021
AT1;AT12;AT126;30824;Gro�-Schweinbarth;0_4;63;38;25;2021
AT1;AT12;AT126;30824;Gro�-Schweinbarth;5_9;66;40;26;2021
AT1;AT12;AT126;30824;Gro�-Schweinbarth;10_14;66;35;31;2021
AT1;AT12;AT126;30824;Gro�-Schweinbarth;15_19;57;33;24;2021
AT1;AT12;AT126;30824;Gro�-Schweinbarth;20_24;100;51;49;2021
AT1;AT12;AT126;30824;Gro�-Schweinbarth;25_29;85;49;36;2021
AT1;AT12;AT126;30824;Gro�-Schweinbarth;30_34;79;38;41;2021
AT1;AT12;AT126;30824;Gro�-Schweinbarth;35_39;86;45;41;2021
AT1;AT12;AT126;30824;Gro�-Schweinbarth;40_44;62;31;31;2021
AT1;AT12;AT126;30824;Gro�-Schweinbarth;45_49;79;37;42;2021
AT1;AT12;AT126;30824;Gro�-Schweinbarth;50_54;102;54;48;2021
AT1;AT12;AT126;30824;Gro�-Schweinbarth;55_59;135;63;72;2021
AT1;AT12;AT126;30824;Gro�-Schweinbarth;60_64;108;57;51;2021
AT1;AT12;AT126;30824;Gro�-Schweinbarth;65_69;66;28;38;2021
AT1;AT12;AT126;30824;Gro�-Schweinbarth;70_74;45;28;17;2021
AT1;AT12;AT126;30824;Gro�-Schweinbarth;75_79;36;13;23;2021
AT1;AT12;AT126;30824;Gro�-Schweinbarth;80_84;43;14;29;2021
AT1;AT12;AT126;30824;Gro�-Schweinbarth;85_89;24;8;16;2021
AT1;AT12;AT126;30824;Gro�-Schweinbarth;90_94;10;4;6;2021
AT1;AT12;AT126;30824;Gro�-Schweinbarth;95_;1;0;1;2021
AT1;AT12;AT126;30825;Haringsee;0_4;35;15;20;2021
AT1;AT12;AT126;30825;Haringsee;5_9;64;38;26;2021
AT1;AT12;AT126;30825;Haringsee;10_14;59;27;32;2021
AT1;AT12;AT126;30825;Haringsee;15_19;66;35;31;2021
AT1;AT12;AT126;30825;Haringsee;20_24;52;24;28;2021
AT1;AT12;AT126;30825;Haringsee;25_29;49;25;24;2021
AT1;AT12;AT126;30825;Haringsee;30_34;80;45;35;2021
AT1;AT12;AT126;30825;Haringsee;35_39;71;25;46;2021
AT1;AT12;AT126;30825;Haringsee;40_44;72;36;36;2021
AT1;AT12;AT126;30825;Haringsee;45_49;92;50;42;2021
AT1;AT12;AT126;30825;Haringsee;50_54;106;44;62;2021
AT1;AT12;AT126;30825;Haringsee;55_59;97;52;45;2021
AT1;AT12;AT126;30825;Haringsee;60_64;85;42;43;2021
AT1;AT12;AT126;30825;Haringsee;65_69;77;39;38;2021
AT1;AT12;AT126;30825;Haringsee;70_74;69;37;32;2021
AT1;AT12;AT126;30825;Haringsee;75_79;34;17;17;2021
AT1;AT12;AT126;30825;Haringsee;80_84;28;6;22;2021
AT1;AT12;AT126;30825;Haringsee;85_89;18;8;10;2021
AT1;AT12;AT126;30825;Haringsee;90_94;12;7;5;2021
AT1;AT12;AT126;30825;Haringsee;95_;4;0;4;2021
AT1;AT12;AT125;30826;Hauskirchen;0_4;55;23;32;2021
AT1;AT12;AT125;30826;Hauskirchen;5_9;65;29;36;2021
AT1;AT12;AT125;30826;Hauskirchen;10_14;67;38;29;2021
AT1;AT12;AT125;30826;Hauskirchen;15_19;61;38;23;2021
AT1;AT12;AT125;30826;Hauskirchen;20_24;53;28;25;2021
AT1;AT12;AT125;30826;Hauskirchen;25_29;39;23;16;2021
AT1;AT12;AT125;30826;Hauskirchen;30_34;76;29;47;2021
AT1;AT12;AT125;30826;Hauskirchen;35_39;79;35;44;2021
AT1;AT12;AT125;30826;Hauskirchen;40_44;81;47;34;2021
AT1;AT12;AT125;30826;Hauskirchen;45_49;101;52;49;2021
AT1;AT12;AT125;30826;Hauskirchen;50_54;90;43;47;2021
AT1;AT12;AT125;30826;Hauskirchen;55_59;104;54;50;2021
AT1;AT12;AT125;30826;Hauskirchen;60_64;113;62;51;2021
AT1;AT12;AT125;30826;Hauskirchen;65_69;101;45;56;2021
AT1;AT12;AT125;30826;Hauskirchen;70_74;72;35;37;2021
AT1;AT12;AT125;30826;Hauskirchen;75_79;46;20;26;2021
AT1;AT12;AT125;30826;Hauskirchen;80_84;47;15;32;2021
AT1;AT12;AT125;30826;Hauskirchen;85_89;22;9;13;2021
AT1;AT12;AT125;30826;Hauskirchen;90_94;8;3;5;2021
AT1;AT12;AT125;30826;Hauskirchen;95_;3;1;2;2021
AT1;AT12;AT125;30827;Hohenau an der March;0_4;134;69;65;2021
AT1;AT12;AT125;30827;Hohenau an der March;5_9;121;64;57;2021
AT1;AT12;AT125;30827;Hohenau an der March;10_14;115;64;51;2021
AT1;AT12;AT125;30827;Hohenau an der March;15_19;108;47;61;2021
AT1;AT12;AT125;30827;Hohenau an der March;20_24;143;69;74;2021
AT1;AT12;AT125;30827;Hohenau an der March;25_29;163;84;79;2021
AT1;AT12;AT125;30827;Hohenau an der March;30_34;144;72;72;2021
AT1;AT12;AT125;30827;Hohenau an der March;35_39;142;67;75;2021
AT1;AT12;AT125;30827;Hohenau an der March;40_44;160;78;82;2021
AT1;AT12;AT125;30827;Hohenau an der March;45_49;178;88;90;2021
AT1;AT12;AT125;30827;Hohenau an der March;50_54;211;108;103;2021
AT1;AT12;AT125;30827;Hohenau an der March;55_59;236;122;114;2021
AT1;AT12;AT125;30827;Hohenau an der March;60_64;191;90;101;2021
AT1;AT12;AT125;30827;Hohenau an der March;65_69;204;93;111;2021
AT1;AT12;AT125;30827;Hohenau an der March;70_74;175;81;94;2021
AT1;AT12;AT125;30827;Hohenau an der March;75_79;138;68;70;2021
AT1;AT12;AT125;30827;Hohenau an der March;80_84;106;35;71;2021
AT1;AT12;AT125;30827;Hohenau an der March;85_89;55;14;41;2021
AT1;AT12;AT125;30827;Hohenau an der March;90_94;27;8;19;2021
AT1;AT12;AT125;30827;Hohenau an der March;95_;6;1;5;2021
AT1;AT12;AT126;30828;Hohenruppersdorf;0_4;49;26;23;2021
AT1;AT12;AT126;30828;Hohenruppersdorf;5_9;48;24;24;2021
AT1;AT12;AT126;30828;Hohenruppersdorf;10_14;40;17;23;2021
AT1;AT12;AT126;30828;Hohenruppersdorf;15_19;31;17;14;2021
AT1;AT12;AT126;30828;Hohenruppersdorf;20_24;47;26;21;2021
AT1;AT12;AT126;30828;Hohenruppersdorf;25_29;48;20;28;2021
AT1;AT12;AT126;30828;Hohenruppersdorf;30_34;77;36;41;2021
AT1;AT12;AT126;30828;Hohenruppersdorf;35_39;65;28;37;2021
AT1;AT12;AT126;30828;Hohenruppersdorf;40_44;60;33;27;2021
AT1;AT12;AT126;30828;Hohenruppersdorf;45_49;76;40;36;2021
AT1;AT12;AT126;30828;Hohenruppersdorf;50_54;71;41;30;2021
AT1;AT12;AT126;30828;Hohenruppersdorf;55_59;67;35;32;2021
AT1;AT12;AT126;30828;Hohenruppersdorf;60_64;64;29;35;2021
AT1;AT12;AT126;30828;Hohenruppersdorf;65_69;63;38;25;2021
AT1;AT12;AT126;30828;Hohenruppersdorf;70_74;44;21;23;2021
AT1;AT12;AT126;30828;Hohenruppersdorf;75_79;32;18;14;2021
AT1;AT12;AT126;30828;Hohenruppersdorf;80_84;40;17;23;2021
AT1;AT12;AT126;30828;Hohenruppersdorf;85_89;13;6;7;2021
AT1;AT12;AT126;30828;Hohenruppersdorf;90_94;10;4;6;2021
AT1;AT12;AT126;30828;Hohenruppersdorf;95_;0;0;0;2021
AT1;AT12;AT125;30829;Jedenspeigen;0_4;53;27;26;2021
AT1;AT12;AT125;30829;Jedenspeigen;5_9;38;22;16;2021
AT1;AT12;AT125;30829;Jedenspeigen;10_14;37;19;18;2021
AT1;AT12;AT125;30829;Jedenspeigen;15_19;49;23;26;2021
AT1;AT12;AT125;30829;Jedenspeigen;20_24;47;32;15;2021
AT1;AT12;AT125;30829;Jedenspeigen;25_29;46;23;23;2021
AT1;AT12;AT125;30829;Jedenspeigen;30_34;65;24;41;2021
AT1;AT12;AT125;30829;Jedenspeigen;35_39;82;46;36;2021
AT1;AT12;AT125;30829;Jedenspeigen;40_44;66;34;32;2021
AT1;AT12;AT125;30829;Jedenspeigen;45_49;71;37;34;2021
AT1;AT12;AT125;30829;Jedenspeigen;50_54;79;37;42;2021
AT1;AT12;AT125;30829;Jedenspeigen;55_59;104;57;47;2021
AT1;AT12;AT125;30829;Jedenspeigen;60_64;87;43;44;2021
AT1;AT12;AT125;30829;Jedenspeigen;65_69;80;38;42;2021
AT1;AT12;AT125;30829;Jedenspeigen;70_74;67;36;31;2021
AT1;AT12;AT125;30829;Jedenspeigen;75_79;40;20;20;2021
AT1;AT12;AT125;30829;Jedenspeigen;80_84;62;27;35;2021
AT1;AT12;AT125;30829;Jedenspeigen;85_89;23;10;13;2021
AT1;AT12;AT125;30829;Jedenspeigen;90_94;10;3;7;2021
AT1;AT12;AT125;30829;Jedenspeigen;95_;0;0;0;2021
AT1;AT12;AT126;30830;Lassee;0_4;152;80;72;2021
AT1;AT12;AT126;30830;Lassee;5_9;149;83;66;2021
AT1;AT12;AT126;30830;Lassee;10_14;129;66;63;2021
AT1;AT12;AT126;30830;Lassee;15_19;156;79;77;2021
AT1;AT12;AT126;30830;Lassee;20_24;133;59;74;2021
AT1;AT12;AT126;30830;Lassee;25_29;188;107;81;2021
AT1;AT12;AT126;30830;Lassee;30_34;219;108;111;2021
AT1;AT12;AT126;30830;Lassee;35_39;224;125;99;2021
AT1;AT12;AT126;30830;Lassee;40_44;174;84;90;2021
AT1;AT12;AT126;30830;Lassee;45_49;222;108;114;2021
AT1;AT12;AT126;30830;Lassee;50_54;268;145;123;2021
AT1;AT12;AT126;30830;Lassee;55_59;246;128;118;2021
AT1;AT12;AT126;30830;Lassee;60_64;177;88;89;2021
AT1;AT12;AT126;30830;Lassee;65_69;142;72;70;2021
AT1;AT12;AT126;30830;Lassee;70_74;130;70;60;2021
AT1;AT12;AT126;30830;Lassee;75_79;105;43;62;2021
AT1;AT12;AT126;30830;Lassee;80_84;69;24;45;2021
AT1;AT12;AT126;30830;Lassee;85_89;50;14;36;2021
AT1;AT12;AT126;30830;Lassee;90_94;15;5;10;2021
AT1;AT12;AT126;30830;Lassee;95_;4;1;3;2021
AT1;AT12;AT126;30831;Leopoldsdorf im Marchfelde;0_4;154;87;67;2021
AT1;AT12;AT126;30831;Leopoldsdorf im Marchfelde;5_9;161;94;67;2021
AT1;AT12;AT126;30831;Leopoldsdorf im Marchfelde;10_14;137;65;72;2021
AT1;AT12;AT126;30831;Leopoldsdorf im Marchfelde;15_19;163;82;81;2021
AT1;AT12;AT126;30831;Leopoldsdorf im Marchfelde;20_24;140;67;73;2021
AT1;AT12;AT126;30831;Leopoldsdorf im Marchfelde;25_29;161;84;77;2021
AT1;AT12;AT126;30831;Leopoldsdorf im Marchfelde;30_34;176;82;94;2021
AT1;AT12;AT126;30831;Leopoldsdorf im Marchfelde;35_39;184;85;99;2021
AT1;AT12;AT126;30831;Leopoldsdorf im Marchfelde;40_44;197;92;105;2021
AT1;AT12;AT126;30831;Leopoldsdorf im Marchfelde;45_49;196;102;94;2021
AT1;AT12;AT126;30831;Leopoldsdorf im Marchfelde;50_54;268;143;125;2021
AT1;AT12;AT126;30831;Leopoldsdorf im Marchfelde;55_59;239;125;114;2021
AT1;AT12;AT126;30831;Leopoldsdorf im Marchfelde;60_64;174;80;94;2021
AT1;AT12;AT126;30831;Leopoldsdorf im Marchfelde;65_69;146;69;77;2021
AT1;AT12;AT126;30831;Leopoldsdorf im Marchfelde;70_74;139;63;76;2021
AT1;AT12;AT126;30831;Leopoldsdorf im Marchfelde;75_79;114;43;71;2021
AT1;AT12;AT126;30831;Leopoldsdorf im Marchfelde;80_84;81;43;38;2021
AT1;AT12;AT126;30831;Leopoldsdorf im Marchfelde;85_89;44;16;28;2021
AT1;AT12;AT126;30831;Leopoldsdorf im Marchfelde;90_94;16;7;9;2021
AT1;AT12;AT126;30831;Leopoldsdorf im Marchfelde;95_;3;0;3;2021
AT1;AT12;AT126;30834;Mannsdorf an der Donau;0_4;11;7;4;2021
AT1;AT12;AT126;30834;Mannsdorf an der Donau;5_9;11;8;3;2021
AT1;AT12;AT126;30834;Mannsdorf an der Donau;10_14;22;12;10;2021
AT1;AT12;AT126;30834;Mannsdorf an der Donau;15_19;12;8;4;2021
AT1;AT12;AT126;30834;Mannsdorf an der Donau;20_24;22;9;13;2021
AT1;AT12;AT126;30834;Mannsdorf an der Donau;25_29;27;19;8;2021
AT1;AT12;AT126;30834;Mannsdorf an der Donau;30_34;19;10;9;2021
AT1;AT12;AT126;30834;Mannsdorf an der Donau;35_39;19;11;8;2021
AT1;AT12;AT126;30834;Mannsdorf an der Donau;40_44;20;9;11;2021
AT1;AT12;AT126;30834;Mannsdorf an der Donau;45_49;23;16;7;2021
AT1;AT12;AT126;30834;Mannsdorf an der Donau;50_54;32;16;16;2021
AT1;AT12;AT126;30834;Mannsdorf an der Donau;55_59;27;11;16;2021
AT1;AT12;AT126;30834;Mannsdorf an der Donau;60_64;36;26;10;2021
AT1;AT12;AT126;30834;Mannsdorf an der Donau;65_69;20;7;13;2021
AT1;AT12;AT126;30834;Mannsdorf an der Donau;70_74;19;11;8;2021
AT1;AT12;AT126;30834;Mannsdorf an der Donau;75_79;9;4;5;2021
AT1;AT12;AT126;30834;Mannsdorf an der Donau;80_84;14;6;8;2021
AT1;AT12;AT126;30834;Mannsdorf an der Donau;85_89;7;1;6;2021
AT1;AT12;AT126;30834;Mannsdorf an der Donau;90_94;2;1;1;2021
AT1;AT12;AT126;30834;Mannsdorf an der Donau;95_;3;0;3;2021
AT1;AT12;AT126;30835;Marchegg;0_4;124;65;59;2021
AT1;AT12;AT126;30835;Marchegg;5_9;134;68;66;2021
AT1;AT12;AT126;30835;Marchegg;10_14;186;91;95;2021
AT1;AT12;AT126;30835;Marchegg;15_19;173;94;79;2021
AT1;AT12;AT126;30835;Marchegg;20_24;136;67;69;2021
AT1;AT12;AT126;30835;Marchegg;25_29;153;70;83;2021
AT1;AT12;AT126;30835;Marchegg;30_34;167;93;74;2021
AT1;AT12;AT126;30835;Marchegg;35_39;186;81;105;2021
AT1;AT12;AT126;30835;Marchegg;40_44;186;95;91;2021
AT1;AT12;AT126;30835;Marchegg;45_49;221;104;117;2021
AT1;AT12;AT126;30835;Marchegg;50_54;260;146;114;2021
AT1;AT12;AT126;30835;Marchegg;55_59;224;111;113;2021
AT1;AT12;AT126;30835;Marchegg;60_64;205;103;102;2021
AT1;AT12;AT126;30835;Marchegg;65_69;151;80;71;2021
AT1;AT12;AT126;30835;Marchegg;70_74;150;74;76;2021
AT1;AT12;AT126;30835;Marchegg;75_79;128;55;73;2021
AT1;AT12;AT126;30835;Marchegg;80_84;127;48;79;2021
AT1;AT12;AT126;30835;Marchegg;85_89;52;22;30;2021
AT1;AT12;AT126;30835;Marchegg;90_94;23;4;19;2021
AT1;AT12;AT126;30835;Marchegg;95_;2;1;1;2021
AT1;AT12;AT126;30836;Markgrafneusiedl;0_4;40;14;26;2021
AT1;AT12;AT126;30836;Markgrafneusiedl;5_9;36;17;19;2021
AT1;AT12;AT126;30836;Markgrafneusiedl;10_14;24;11;13;2021
AT1;AT12;AT126;30836;Markgrafneusiedl;15_19;40;25;15;2021
AT1;AT12;AT126;30836;Markgrafneusiedl;20_24;61;29;32;2021
AT1;AT12;AT126;30836;Markgrafneusiedl;25_29;55;27;28;2021
AT1;AT12;AT126;30836;Markgrafneusiedl;30_34;58;30;28;2021
AT1;AT12;AT126;30836;Markgrafneusiedl;35_39;63;27;36;2021
AT1;AT12;AT126;30836;Markgrafneusiedl;40_44;61;32;29;2021
AT1;AT12;AT126;30836;Markgrafneusiedl;45_49;69;29;40;2021
AT1;AT12;AT126;30836;Markgrafneusiedl;50_54;71;34;37;2021
AT1;AT12;AT126;30836;Markgrafneusiedl;55_59;73;35;38;2021
AT1;AT12;AT126;30836;Markgrafneusiedl;60_64;67;37;30;2021
AT1;AT12;AT126;30836;Markgrafneusiedl;65_69;52;28;24;2021
AT1;AT12;AT126;30836;Markgrafneusiedl;70_74;40;20;20;2021
AT1;AT12;AT126;30836;Markgrafneusiedl;75_79;30;10;20;2021
AT1;AT12;AT126;30836;Markgrafneusiedl;80_84;31;13;18;2021
AT1;AT12;AT126;30836;Markgrafneusiedl;85_89;14;8;6;2021
AT1;AT12;AT126;30836;Markgrafneusiedl;90_94;7;0;7;2021
AT1;AT12;AT126;30836;Markgrafneusiedl;95_;0;0;0;2021
AT1;AT12;AT126;30838;Matzen-Raggendorf;0_4;142;66;76;2021
AT1;AT12;AT126;30838;Matzen-Raggendorf;5_9;134;68;66;2021
AT1;AT12;AT126;30838;Matzen-Raggendorf;10_14;159;78;81;2021
AT1;AT12;AT126;30838;Matzen-Raggendorf;15_19;148;73;75;2021
AT1;AT12;AT126;30838;Matzen-Raggendorf;20_24;125;59;66;2021
AT1;AT12;AT126;30838;Matzen-Raggendorf;25_29;168;87;81;2021
AT1;AT12;AT126;30838;Matzen-Raggendorf;30_34;165;75;90;2021
AT1;AT12;AT126;30838;Matzen-Raggendorf;35_39;188;94;94;2021
AT1;AT12;AT126;30838;Matzen-Raggendorf;40_44;150;86;64;2021
AT1;AT12;AT126;30838;Matzen-Raggendorf;45_49;195;85;110;2021
AT1;AT12;AT126;30838;Matzen-Raggendorf;50_54;258;140;118;2021
AT1;AT12;AT126;30838;Matzen-Raggendorf;55_59;251;135;116;2021
AT1;AT12;AT126;30838;Matzen-Raggendorf;60_64;174;86;88;2021
AT1;AT12;AT126;30838;Matzen-Raggendorf;65_69;164;83;81;2021
AT1;AT12;AT126;30838;Matzen-Raggendorf;70_74;111;53;58;2021
AT1;AT12;AT126;30838;Matzen-Raggendorf;75_79;109;47;62;2021
AT1;AT12;AT126;30838;Matzen-Raggendorf;80_84;90;44;46;2021
AT1;AT12;AT126;30838;Matzen-Raggendorf;85_89;36;13;23;2021
AT1;AT12;AT126;30838;Matzen-Raggendorf;90_94;13;7;6;2021
AT1;AT12;AT126;30838;Matzen-Raggendorf;95_;5;1;4;2021
AT1;AT12;AT125;30841;Neusiedl an der Zaya;0_4;49;24;25;2021
AT1;AT12;AT125;30841;Neusiedl an der Zaya;5_9;54;27;27;2021
AT1;AT12;AT125;30841;Neusiedl an der Zaya;10_14;53;29;24;2021
AT1;AT12;AT125;30841;Neusiedl an der Zaya;15_19;45;20;25;2021
AT1;AT12;AT125;30841;Neusiedl an der Zaya;20_24;56;27;29;2021
AT1;AT12;AT125;30841;Neusiedl an der Zaya;25_29;74;42;32;2021
AT1;AT12;AT125;30841;Neusiedl an der Zaya;30_34;74;35;39;2021
AT1;AT12;AT125;30841;Neusiedl an der Zaya;35_39;75;37;38;2021
AT1;AT12;AT125;30841;Neusiedl an der Zaya;40_44;66;38;28;2021
AT1;AT12;AT125;30841;Neusiedl an der Zaya;45_49;80;38;42;2021
AT1;AT12;AT125;30841;Neusiedl an der Zaya;50_54;101;55;46;2021
AT1;AT12;AT125;30841;Neusiedl an der Zaya;55_59;97;43;54;2021
AT1;AT12;AT125;30841;Neusiedl an der Zaya;60_64;112;63;49;2021
AT1;AT12;AT125;30841;Neusiedl an der Zaya;65_69;96;47;49;2021
AT1;AT12;AT125;30841;Neusiedl an der Zaya;70_74;71;36;35;2021
AT1;AT12;AT125;30841;Neusiedl an der Zaya;75_79;42;26;16;2021
AT1;AT12;AT125;30841;Neusiedl an der Zaya;80_84;43;13;30;2021
AT1;AT12;AT125;30841;Neusiedl an der Zaya;85_89;28;11;17;2021
AT1;AT12;AT125;30841;Neusiedl an der Zaya;90_94;12;4;8;2021
AT1;AT12;AT125;30841;Neusiedl an der Zaya;95_;2;0;2;2021
AT1;AT12;AT126;30842;Obersiebenbrunn;0_4;64;34;30;2021
AT1;AT12;AT126;30842;Obersiebenbrunn;5_9;88;40;48;2021
AT1;AT12;AT126;30842;Obersiebenbrunn;10_14;81;43;38;2021
AT1;AT12;AT126;30842;Obersiebenbrunn;15_19;111;61;50;2021
AT1;AT12;AT126;30842;Obersiebenbrunn;20_24;114;55;59;2021
AT1;AT12;AT126;30842;Obersiebenbrunn;25_29;100;51;49;2021
AT1;AT12;AT126;30842;Obersiebenbrunn;30_34;89;46;43;2021
AT1;AT12;AT126;30842;Obersiebenbrunn;35_39;103;51;52;2021
AT1;AT12;AT126;30842;Obersiebenbrunn;40_44;108;54;54;2021
AT1;AT12;AT126;30842;Obersiebenbrunn;45_49;144;81;63;2021
AT1;AT12;AT126;30842;Obersiebenbrunn;50_54;170;88;82;2021
AT1;AT12;AT126;30842;Obersiebenbrunn;55_59;168;83;85;2021
AT1;AT12;AT126;30842;Obersiebenbrunn;60_64;112;62;50;2021
AT1;AT12;AT126;30842;Obersiebenbrunn;65_69;79;36;43;2021
AT1;AT12;AT126;30842;Obersiebenbrunn;70_74;69;31;38;2021
AT1;AT12;AT126;30842;Obersiebenbrunn;75_79;61;35;26;2021
AT1;AT12;AT126;30842;Obersiebenbrunn;80_84;55;23;32;2021
AT1;AT12;AT126;30842;Obersiebenbrunn;85_89;26;10;16;2021
AT1;AT12;AT126;30842;Obersiebenbrunn;90_94;7;4;3;2021
AT1;AT12;AT126;30842;Obersiebenbrunn;95_;1;0;1;2021
AT1;AT12;AT126;30844;Orth an der Donau;0_4;96;51;45;2021
AT1;AT12;AT126;30844;Orth an der Donau;5_9;120;58;62;2021
AT1;AT12;AT126;30844;Orth an der Donau;10_14;101;51;50;2021
AT1;AT12;AT126;30844;Orth an der Donau;15_19;108;58;50;2021
AT1;AT12;AT126;30844;Orth an der Donau;20_24;102;53;49;2021
AT1;AT12;AT126;30844;Orth an der Donau;25_29;100;47;53;2021
AT1;AT12;AT126;30844;Orth an der Donau;30_34;135;70;65;2021
AT1;AT12;AT126;30844;Orth an der Donau;35_39;144;69;75;2021
AT1;AT12;AT126;30844;Orth an der Donau;40_44;145;68;77;2021
AT1;AT12;AT126;30844;Orth an der Donau;45_49;151;78;73;2021
AT1;AT12;AT126;30844;Orth an der Donau;50_54;144;72;72;2021
AT1;AT12;AT126;30844;Orth an der Donau;55_59;177;86;91;2021
AT1;AT12;AT126;30844;Orth an der Donau;60_64;141;67;74;2021
AT1;AT12;AT126;30844;Orth an der Donau;65_69;121;56;65;2021
AT1;AT12;AT126;30844;Orth an der Donau;70_74;90;43;47;2021
AT1;AT12;AT126;30844;Orth an der Donau;75_79;101;43;58;2021
AT1;AT12;AT126;30844;Orth an der Donau;80_84;95;37;58;2021
AT1;AT12;AT126;30844;Orth an der Donau;85_89;52;14;38;2021
AT1;AT12;AT126;30844;Orth an der Donau;90_94;35;9;26;2021
AT1;AT12;AT126;30844;Orth an der Donau;95_;15;3;12;2021
AT1;AT12;AT125;30845;Palterndorf-Dobermannsdorf;0_4;54;28;26;2021
AT1;AT12;AT125;30845;Palterndorf-Dobermannsdorf;5_9;78;42;36;2021
AT1;AT12;AT125;30845;Palterndorf-Dobermannsdorf;10_14;61;28;33;2021
AT1;AT12;AT125;30845;Palterndorf-Dobermannsdorf;15_19;64;32;32;2021
AT1;AT12;AT125;30845;Palterndorf-Dobermannsdorf;20_24;58;29;29;2021
AT1;AT12;AT125;30845;Palterndorf-Dobermannsdorf;25_29;55;25;30;2021
AT1;AT12;AT125;30845;Palterndorf-Dobermannsdorf;30_34;68;30;38;2021
AT1;AT12;AT125;30845;Palterndorf-Dobermannsdorf;35_39;78;36;42;2021
AT1;AT12;AT125;30845;Palterndorf-Dobermannsdorf;40_44;89;48;41;2021
AT1;AT12;AT125;30845;Palterndorf-Dobermannsdorf;45_49;99;53;46;2021
AT1;AT12;AT125;30845;Palterndorf-Dobermannsdorf;50_54;99;58;41;2021
AT1;AT12;AT125;30845;Palterndorf-Dobermannsdorf;55_59;129;65;64;2021
AT1;AT12;AT125;30845;Palterndorf-Dobermannsdorf;60_64;101;43;58;2021
AT1;AT12;AT125;30845;Palterndorf-Dobermannsdorf;65_69;84;43;41;2021
AT1;AT12;AT125;30845;Palterndorf-Dobermannsdorf;70_74;75;34;41;2021
AT1;AT12;AT125;30845;Palterndorf-Dobermannsdorf;75_79;54;27;27;2021
AT1;AT12;AT125;30845;Palterndorf-Dobermannsdorf;80_84;57;26;31;2021
AT1;AT12;AT125;30845;Palterndorf-Dobermannsdorf;85_89;22;8;14;2021
AT1;AT12;AT125;30845;Palterndorf-Dobermannsdorf;90_94;16;4;12;2021
AT1;AT12;AT125;30845;Palterndorf-Dobermannsdorf;95_;0;0;0;2021
AT1;AT12;AT126;30846;Parbasdorf;0_4;10;5;5;2021
AT1;AT12;AT126;30846;Parbasdorf;5_9;15;8;7;2021
AT1;AT12;AT126;30846;Parbasdorf;10_14;9;7;2;2021
AT1;AT12;AT126;30846;Parbasdorf;15_19;11;8;3;2021
AT1;AT12;AT126;30846;Parbasdorf;20_24;6;2;4;2021
AT1;AT12;AT126;30846;Parbasdorf;25_29;10;5;5;2021
AT1;AT12;AT126;30846;Parbasdorf;30_34;12;5;7;2021
AT1;AT12;AT126;30846;Parbasdorf;35_39;8;4;4;2021
AT1;AT12;AT126;30846;Parbasdorf;40_44;13;5;8;2021
AT1;AT12;AT126;30846;Parbasdorf;45_49;15;10;5;2021
AT1;AT12;AT126;30846;Parbasdorf;50_54;11;6;5;2021
AT1;AT12;AT126;30846;Parbasdorf;55_59;14;7;7;2021
AT1;AT12;AT126;30846;Parbasdorf;60_64;11;5;6;2021
AT1;AT12;AT126;30846;Parbasdorf;65_69;7;4;3;2021
AT1;AT12;AT126;30846;Parbasdorf;70_74;9;6;3;2021
AT1;AT12;AT126;30846;Parbasdorf;75_79;4;0;4;2021
AT1;AT12;AT126;30846;Parbasdorf;80_84;3;1;2;2021
AT1;AT12;AT126;30846;Parbasdorf;85_89;5;1;4;2021
AT1;AT12;AT126;30846;Parbasdorf;90_94;0;0;0;2021
AT1;AT12;AT126;30846;Parbasdorf;95_;0;0;0;2021
AT1;AT12;AT126;30848;Prottes;0_4;71;29;42;2021
AT1;AT12;AT126;30848;Prottes;5_9;77;43;34;2021
AT1;AT12;AT126;30848;Prottes;10_14;70;38;32;2021
AT1;AT12;AT126;30848;Prottes;15_19;68;42;26;2021
AT1;AT12;AT126;30848;Prottes;20_24;62;33;29;2021
AT1;AT12;AT126;30848;Prottes;25_29;78;34;44;2021
AT1;AT12;AT126;30848;Prottes;30_34;99;48;51;2021
AT1;AT12;AT126;30848;Prottes;35_39;109;61;48;2021
AT1;AT12;AT126;30848;Prottes;40_44;78;39;39;2021
AT1;AT12;AT126;30848;Prottes;45_49;94;42;52;2021
AT1;AT12;AT126;30848;Prottes;50_54;133;65;68;2021
AT1;AT12;AT126;30848;Prottes;55_59;122;63;59;2021
AT1;AT12;AT126;30848;Prottes;60_64;116;56;60;2021
AT1;AT12;AT126;30848;Prottes;65_69;67;34;33;2021
AT1;AT12;AT126;30848;Prottes;70_74;75;38;37;2021
AT1;AT12;AT126;30848;Prottes;75_79;52;18;34;2021
AT1;AT12;AT126;30848;Prottes;80_84;46;21;25;2021
AT1;AT12;AT126;30848;Prottes;85_89;25;10;15;2021
AT1;AT12;AT126;30848;Prottes;90_94;8;3;5;2021
AT1;AT12;AT126;30848;Prottes;95_;2;0;2;2021
AT1;AT12;AT126;30849;Raasdorf;0_4;28;14;14;2021
AT1;AT12;AT126;30849;Raasdorf;5_9;31;19;12;2021
AT1;AT12;AT126;30849;Raasdorf;10_14;41;19;22;2021
AT1;AT12;AT126;30849;Raasdorf;15_19;36;25;11;2021
AT1;AT12;AT126;30849;Raasdorf;20_24;30;18;12;2021
AT1;AT12;AT126;30849;Raasdorf;25_29;35;19;16;2021
AT1;AT12;AT126;30849;Raasdorf;30_34;36;22;14;2021
AT1;AT12;AT126;30849;Raasdorf;35_39;50;27;23;2021
AT1;AT12;AT126;30849;Raasdorf;40_44;46;21;25;2021
AT1;AT12;AT126;30849;Raasdorf;45_49;59;31;28;2021
AT1;AT12;AT126;30849;Raasdorf;50_54;67;33;34;2021
AT1;AT12;AT126;30849;Raasdorf;55_59;51;32;19;2021
AT1;AT12;AT126;30849;Raasdorf;60_64;35;19;16;2021
AT1;AT12;AT126;30849;Raasdorf;65_69;34;11;23;2021
AT1;AT12;AT126;30849;Raasdorf;70_74;26;11;15;2021
AT1;AT12;AT126;30849;Raasdorf;75_79;29;17;12;2021
AT1;AT12;AT126;30849;Raasdorf;80_84;10;4;6;2021
AT1;AT12;AT126;30849;Raasdorf;85_89;12;4;8;2021
AT1;AT12;AT126;30849;Raasdorf;90_94;6;2;4;2021
AT1;AT12;AT126;30849;Raasdorf;95_;3;1;2;2021
AT1;AT12;AT125;30850;Ringelsdorf-Niederabsdorf;0_4;52;30;22;2021
AT1;AT12;AT125;30850;Ringelsdorf-Niederabsdorf;5_9;50;21;29;2021
AT1;AT12;AT125;30850;Ringelsdorf-Niederabsdorf;10_14;47;21;26;2021
AT1;AT12;AT125;30850;Ringelsdorf-Niederabsdorf;15_19;50;21;29;2021
AT1;AT12;AT125;30850;Ringelsdorf-Niederabsdorf;20_24;56;36;20;2021
AT1;AT12;AT125;30850;Ringelsdorf-Niederabsdorf;25_29;62;33;29;2021
AT1;AT12;AT125;30850;Ringelsdorf-Niederabsdorf;30_34;68;36;32;2021
AT1;AT12;AT125;30850;Ringelsdorf-Niederabsdorf;35_39;66;30;36;2021
AT1;AT12;AT125;30850;Ringelsdorf-Niederabsdorf;40_44;70;40;30;2021
AT1;AT12;AT125;30850;Ringelsdorf-Niederabsdorf;45_49;84;39;45;2021
AT1;AT12;AT125;30850;Ringelsdorf-Niederabsdorf;50_54;89;49;40;2021
AT1;AT12;AT125;30850;Ringelsdorf-Niederabsdorf;55_59;130;55;75;2021
AT1;AT12;AT125;30850;Ringelsdorf-Niederabsdorf;60_64;122;68;54;2021
AT1;AT12;AT125;30850;Ringelsdorf-Niederabsdorf;65_69;92;47;45;2021
AT1;AT12;AT125;30850;Ringelsdorf-Niederabsdorf;70_74;68;36;32;2021
AT1;AT12;AT125;30850;Ringelsdorf-Niederabsdorf;75_79;43;24;19;2021
AT1;AT12;AT125;30850;Ringelsdorf-Niederabsdorf;80_84;46;18;28;2021
AT1;AT12;AT125;30850;Ringelsdorf-Niederabsdorf;85_89;28;12;16;2021
AT1;AT12;AT125;30850;Ringelsdorf-Niederabsdorf;90_94;10;4;6;2021
AT1;AT12;AT125;30850;Ringelsdorf-Niederabsdorf;95_;1;1;0;2021
AT1;AT12;AT126;30852;Sch�nkirchen-Reyersdorf;0_4;88;40;48;2021
AT1;AT12;AT126;30852;Sch�nkirchen-Reyersdorf;5_9;91;45;46;2021
AT1;AT12;AT126;30852;Sch�nkirchen-Reyersdorf;10_14;101;49;52;2021
AT1;AT12;AT126;30852;Sch�nkirchen-Reyersdorf;15_19;114;58;56;2021
AT1;AT12;AT126;30852;Sch�nkirchen-Reyersdorf;20_24;103;61;42;2021
AT1;AT12;AT126;30852;Sch�nkirchen-Reyersdorf;25_29;87;50;37;2021
AT1;AT12;AT126;30852;Sch�nkirchen-Reyersdorf;30_34;113;60;53;2021
AT1;AT12;AT126;30852;Sch�nkirchen-Reyersdorf;35_39;115;52;63;2021
AT1;AT12;AT126;30852;Sch�nkirchen-Reyersdorf;40_44;142;74;68;2021
AT1;AT12;AT126;30852;Sch�nkirchen-Reyersdorf;45_49;141;70;71;2021
AT1;AT12;AT126;30852;Sch�nkirchen-Reyersdorf;50_54;151;73;78;2021
AT1;AT12;AT126;30852;Sch�nkirchen-Reyersdorf;55_59;168;81;87;2021
AT1;AT12;AT126;30852;Sch�nkirchen-Reyersdorf;60_64;168;90;78;2021
AT1;AT12;AT126;30852;Sch�nkirchen-Reyersdorf;65_69;132;62;70;2021
AT1;AT12;AT126;30852;Sch�nkirchen-Reyersdorf;70_74;102;53;49;2021
AT1;AT12;AT126;30852;Sch�nkirchen-Reyersdorf;75_79;62;27;35;2021
AT1;AT12;AT126;30852;Sch�nkirchen-Reyersdorf;80_84;68;33;35;2021
AT1;AT12;AT126;30852;Sch�nkirchen-Reyersdorf;85_89;27;11;16;2021
AT1;AT12;AT126;30852;Sch�nkirchen-Reyersdorf;90_94;6;3;3;2021
AT1;AT12;AT126;30852;Sch�nkirchen-Reyersdorf;95_;4;1;3;2021
AT1;AT12;AT126;30854;Spannberg;0_4;38;21;17;2021
AT1;AT12;AT126;30854;Spannberg;5_9;61;24;37;2021
AT1;AT12;AT126;30854;Spannberg;10_14;51;29;22;2021
AT1;AT12;AT126;30854;Spannberg;15_19;44;22;22;2021
AT1;AT12;AT126;30854;Spannberg;20_24;39;25;14;2021
AT1;AT12;AT126;30854;Spannberg;25_29;55;25;30;2021
AT1;AT12;AT126;30854;Spannberg;30_34;67;31;36;2021
AT1;AT12;AT126;30854;Spannberg;35_39;67;35;32;2021
AT1;AT12;AT126;30854;Spannberg;40_44;64;37;27;2021
AT1;AT12;AT126;30854;Spannberg;45_49;74;34;40;2021
AT1;AT12;AT126;30854;Spannberg;50_54;73;44;29;2021
AT1;AT12;AT126;30854;Spannberg;55_59;84;35;49;2021
AT1;AT12;AT126;30854;Spannberg;60_64;85;45;40;2021
AT1;AT12;AT126;30854;Spannberg;65_69;54;35;19;2021
AT1;AT12;AT126;30854;Spannberg;70_74;38;18;20;2021
AT1;AT12;AT126;30854;Spannberg;75_79;37;15;22;2021
AT1;AT12;AT126;30854;Spannberg;80_84;27;12;15;2021
AT1;AT12;AT126;30854;Spannberg;85_89;20;4;16;2021
AT1;AT12;AT126;30854;Spannberg;90_94;7;2;5;2021
AT1;AT12;AT126;30854;Spannberg;95_;2;0;2;2021
AT1;AT12;AT126;30856;Strasshof an der Nordbahn;0_4;644;311;333;2021
AT1;AT12;AT126;30856;Strasshof an der Nordbahn;5_9;682;360;322;2021
AT1;AT12;AT126;30856;Strasshof an der Nordbahn;10_14;649;358;291;2021
AT1;AT12;AT126;30856;Strasshof an der Nordbahn;15_19;561;285;276;2021
AT1;AT12;AT126;30856;Strasshof an der Nordbahn;20_24;498;244;254;2021
AT1;AT12;AT126;30856;Strasshof an der Nordbahn;25_29;662;321;341;2021
AT1;AT12;AT126;30856;Strasshof an der Nordbahn;30_34;745;358;387;2021
AT1;AT12;AT126;30856;Strasshof an der Nordbahn;35_39;814;405;409;2021
AT1;AT12;AT126;30856;Strasshof an der Nordbahn;40_44;746;373;373;2021
AT1;AT12;AT126;30856;Strasshof an der Nordbahn;45_49;808;410;398;2021
AT1;AT12;AT126;30856;Strasshof an der Nordbahn;50_54;885;440;445;2021
AT1;AT12;AT126;30856;Strasshof an der Nordbahn;55_59;849;428;421;2021
AT1;AT12;AT126;30856;Strasshof an der Nordbahn;60_64;636;328;308;2021
AT1;AT12;AT126;30856;Strasshof an der Nordbahn;65_69;540;264;276;2021
AT1;AT12;AT126;30856;Strasshof an der Nordbahn;70_74;424;179;245;2021
AT1;AT12;AT126;30856;Strasshof an der Nordbahn;75_79;405;180;225;2021
AT1;AT12;AT126;30856;Strasshof an der Nordbahn;80_84;321;156;165;2021
AT1;AT12;AT126;30856;Strasshof an der Nordbahn;85_89;138;61;77;2021
AT1;AT12;AT126;30856;Strasshof an der Nordbahn;90_94;63;19;44;2021
AT1;AT12;AT126;30856;Strasshof an der Nordbahn;95_;15;3;12;2021
AT1;AT12;AT125;30857;Sulz im Weinviertel;0_4;35;17;18;2021
AT1;AT12;AT125;30857;Sulz im Weinviertel;5_9;57;24;33;2021
AT1;AT12;AT125;30857;Sulz im Weinviertel;10_14;54;29;25;2021
AT1;AT12;AT125;30857;Sulz im Weinviertel;15_19;42;23;19;2021
AT1;AT12;AT125;30857;Sulz im Weinviertel;20_24;59;30;29;2021
AT1;AT12;AT125;30857;Sulz im Weinviertel;25_29;68;36;32;2021
AT1;AT12;AT125;30857;Sulz im Weinviertel;30_34;68;29;39;2021
AT1;AT12;AT125;30857;Sulz im Weinviertel;35_39;71;36;35;2021
AT1;AT12;AT125;30857;Sulz im Weinviertel;40_44;67;40;27;2021
AT1;AT12;AT125;30857;Sulz im Weinviertel;45_49;83;43;40;2021
AT1;AT12;AT125;30857;Sulz im Weinviertel;50_54;110;53;57;2021
AT1;AT12;AT125;30857;Sulz im Weinviertel;55_59;115;55;60;2021
AT1;AT12;AT125;30857;Sulz im Weinviertel;60_64;102;51;51;2021
AT1;AT12;AT125;30857;Sulz im Weinviertel;65_69;75;40;35;2021
AT1;AT12;AT125;30857;Sulz im Weinviertel;70_74;68;37;31;2021
AT1;AT12;AT125;30857;Sulz im Weinviertel;75_79;35;22;13;2021
AT1;AT12;AT125;30857;Sulz im Weinviertel;80_84;59;26;33;2021
AT1;AT12;AT125;30857;Sulz im Weinviertel;85_89;22;6;16;2021
AT1;AT12;AT125;30857;Sulz im Weinviertel;90_94;9;6;3;2021
AT1;AT12;AT125;30857;Sulz im Weinviertel;95_;2;0;2;2021
AT1;AT12;AT126;30858;Untersiebenbrunn;0_4;89;54;35;2021
AT1;AT12;AT126;30858;Untersiebenbrunn;5_9;87;45;42;2021
AT1;AT12;AT126;30858;Untersiebenbrunn;10_14;85;37;48;2021
AT1;AT12;AT126;30858;Untersiebenbrunn;15_19;78;43;35;2021
AT1;AT12;AT126;30858;Untersiebenbrunn;20_24;81;37;44;2021
AT1;AT12;AT126;30858;Untersiebenbrunn;25_29;125;58;67;2021
AT1;AT12;AT126;30858;Untersiebenbrunn;30_34;126;65;61;2021
AT1;AT12;AT126;30858;Untersiebenbrunn;35_39;119;62;57;2021
AT1;AT12;AT126;30858;Untersiebenbrunn;40_44;108;55;53;2021
AT1;AT12;AT126;30858;Untersiebenbrunn;45_49;109;57;52;2021
AT1;AT12;AT126;30858;Untersiebenbrunn;50_54;161;74;87;2021
AT1;AT12;AT126;30858;Untersiebenbrunn;55_59;168;93;75;2021
AT1;AT12;AT126;30858;Untersiebenbrunn;60_64;123;58;65;2021
AT1;AT12;AT126;30858;Untersiebenbrunn;65_69;88;46;42;2021
AT1;AT12;AT126;30858;Untersiebenbrunn;70_74;81;30;51;2021
AT1;AT12;AT126;30858;Untersiebenbrunn;75_79;53;26;27;2021
AT1;AT12;AT126;30858;Untersiebenbrunn;80_84;53;23;30;2021
AT1;AT12;AT126;30858;Untersiebenbrunn;85_89;22;6;16;2021
AT1;AT12;AT126;30858;Untersiebenbrunn;90_94;11;2;9;2021
AT1;AT12;AT126;30858;Untersiebenbrunn;95_;1;0;1;2021
AT1;AT12;AT126;30859;Velm-G�tzendorf;0_4;39;20;19;2021
AT1;AT12;AT126;30859;Velm-G�tzendorf;5_9;36;18;18;2021
AT1;AT12;AT126;30859;Velm-G�tzendorf;10_14;31;21;10;2021
AT1;AT12;AT126;30859;Velm-G�tzendorf;15_19;14;9;5;2021
AT1;AT12;AT126;30859;Velm-G�tzendorf;20_24;37;17;20;2021
AT1;AT12;AT126;30859;Velm-G�tzendorf;25_29;39;18;21;2021
AT1;AT12;AT126;30859;Velm-G�tzendorf;30_34;55;26;29;2021
AT1;AT12;AT126;30859;Velm-G�tzendorf;35_39;49;26;23;2021
AT1;AT12;AT126;30859;Velm-G�tzendorf;40_44;45;26;19;2021
AT1;AT12;AT126;30859;Velm-G�tzendorf;45_49;43;27;16;2021
AT1;AT12;AT126;30859;Velm-G�tzendorf;50_54;47;21;26;2021
AT1;AT12;AT126;30859;Velm-G�tzendorf;55_59;72;42;30;2021
AT1;AT12;AT126;30859;Velm-G�tzendorf;60_64;70;31;39;2021
AT1;AT12;AT126;30859;Velm-G�tzendorf;65_69;54;27;27;2021
AT1;AT12;AT126;30859;Velm-G�tzendorf;70_74;49;24;25;2021
AT1;AT12;AT126;30859;Velm-G�tzendorf;75_79;27;15;12;2021
AT1;AT12;AT126;30859;Velm-G�tzendorf;80_84;28;9;19;2021
AT1;AT12;AT126;30859;Velm-G�tzendorf;85_89;21;6;15;2021
AT1;AT12;AT126;30859;Velm-G�tzendorf;90_94;6;3;3;2021
AT1;AT12;AT126;30859;Velm-G�tzendorf;95_;3;0;3;2021
AT1;AT12;AT126;30860;Weikendorf;0_4;96;54;42;2021
AT1;AT12;AT126;30860;Weikendorf;5_9;109;57;52;2021
AT1;AT12;AT126;30860;Weikendorf;10_14;130;65;65;2021
AT1;AT12;AT126;30860;Weikendorf;15_19;96;50;46;2021
AT1;AT12;AT126;30860;Weikendorf;20_24;92;46;46;2021
AT1;AT12;AT126;30860;Weikendorf;25_29;87;33;54;2021
AT1;AT12;AT126;30860;Weikendorf;30_34;113;55;58;2021
AT1;AT12;AT126;30860;Weikendorf;35_39;124;65;59;2021
AT1;AT12;AT126;30860;Weikendorf;40_44;132;63;69;2021
AT1;AT12;AT126;30860;Weikendorf;45_49;133;63;70;2021
AT1;AT12;AT126;30860;Weikendorf;50_54;162;79;83;2021
AT1;AT12;AT126;30860;Weikendorf;55_59;172;80;92;2021
AT1;AT12;AT126;30860;Weikendorf;60_64;166;85;81;2021
AT1;AT12;AT126;30860;Weikendorf;65_69;125;63;62;2021
AT1;AT12;AT126;30860;Weikendorf;70_74;107;58;49;2021
AT1;AT12;AT126;30860;Weikendorf;75_79;78;32;46;2021
AT1;AT12;AT126;30860;Weikendorf;80_84;67;34;33;2021
AT1;AT12;AT126;30860;Weikendorf;85_89;32;13;19;2021
AT1;AT12;AT126;30860;Weikendorf;90_94;17;2;15;2021
AT1;AT12;AT126;30860;Weikendorf;95_;4;2;2;2021
AT1;AT12;AT125;30863;Zistersdorf;0_4;210;117;93;2021
AT1;AT12;AT125;30863;Zistersdorf;5_9;204;94;110;2021
AT1;AT12;AT125;30863;Zistersdorf;10_14;232;116;116;2021
AT1;AT12;AT125;30863;Zistersdorf;15_19;229;118;111;2021
AT1;AT12;AT125;30863;Zistersdorf;20_24;267;148;119;2021
AT1;AT12;AT125;30863;Zistersdorf;25_29;285;152;133;2021
AT1;AT12;AT125;30863;Zistersdorf;30_34;293;143;150;2021
AT1;AT12;AT125;30863;Zistersdorf;35_39;279;131;148;2021
AT1;AT12;AT125;30863;Zistersdorf;40_44;315;164;151;2021
AT1;AT12;AT125;30863;Zistersdorf;45_49;354;169;185;2021
AT1;AT12;AT125;30863;Zistersdorf;50_54;466;235;231;2021
AT1;AT12;AT125;30863;Zistersdorf;55_59;464;241;223;2021
AT1;AT12;AT125;30863;Zistersdorf;60_64;443;219;224;2021
AT1;AT12;AT125;30863;Zistersdorf;65_69;348;173;175;2021
AT1;AT12;AT125;30863;Zistersdorf;70_74;293;138;155;2021
AT1;AT12;AT125;30863;Zistersdorf;75_79;215;103;112;2021
AT1;AT12;AT125;30863;Zistersdorf;80_84;247;96;151;2021
AT1;AT12;AT125;30863;Zistersdorf;85_89;128;46;82;2021
AT1;AT12;AT125;30863;Zistersdorf;90_94;59;21;38;2021
AT1;AT12;AT125;30863;Zistersdorf;95_;25;3;22;2021
AT1;AT12;AT126;30865;Weiden an der March;0_4;44;21;23;2021
AT1;AT12;AT126;30865;Weiden an der March;5_9;40;18;22;2021
AT1;AT12;AT126;30865;Weiden an der March;10_14;45;30;15;2021
AT1;AT12;AT126;30865;Weiden an der March;15_19;48;25;23;2021
AT1;AT12;AT126;30865;Weiden an der March;20_24;43;22;21;2021
AT1;AT12;AT126;30865;Weiden an der March;25_29;61;32;29;2021
AT1;AT12;AT126;30865;Weiden an der March;30_34;47;22;25;2021
AT1;AT12;AT126;30865;Weiden an der March;35_39;71;37;34;2021
AT1;AT12;AT126;30865;Weiden an der March;40_44;71;43;28;2021
AT1;AT12;AT126;30865;Weiden an der March;45_49;72;31;41;2021
AT1;AT12;AT126;30865;Weiden an der March;50_54;72;40;32;2021
AT1;AT12;AT126;30865;Weiden an der March;55_59;93;52;41;2021
AT1;AT12;AT126;30865;Weiden an der March;60_64;80;43;37;2021
AT1;AT12;AT126;30865;Weiden an der March;65_69;52;27;25;2021
AT1;AT12;AT126;30865;Weiden an der March;70_74;47;27;20;2021
AT1;AT12;AT126;30865;Weiden an der March;75_79;42;16;26;2021
AT1;AT12;AT126;30865;Weiden an der March;80_84;30;11;19;2021
AT1;AT12;AT126;30865;Weiden an der March;85_89;16;6;10;2021
AT1;AT12;AT126;30865;Weiden an der March;90_94;9;4;5;2021
AT1;AT12;AT126;30865;Weiden an der March;95_;2;1;1;2021
AT1;AT12;AT124;30902;Amaliendorf-Aalfang;0_4;51;26;25;2021
AT1;AT12;AT124;30902;Amaliendorf-Aalfang;5_9;41;22;19;2021
AT1;AT12;AT124;30902;Amaliendorf-Aalfang;10_14;44;20;24;2021
AT1;AT12;AT124;30902;Amaliendorf-Aalfang;15_19;55;29;26;2021
AT1;AT12;AT124;30902;Amaliendorf-Aalfang;20_24;45;19;26;2021
AT1;AT12;AT124;30902;Amaliendorf-Aalfang;25_29;71;32;39;2021
AT1;AT12;AT124;30902;Amaliendorf-Aalfang;30_34;67;33;34;2021
AT1;AT12;AT124;30902;Amaliendorf-Aalfang;35_39;54;30;24;2021
AT1;AT12;AT124;30902;Amaliendorf-Aalfang;40_44;54;27;27;2021
AT1;AT12;AT124;30902;Amaliendorf-Aalfang;45_49;81;37;44;2021
AT1;AT12;AT124;30902;Amaliendorf-Aalfang;50_54;100;54;46;2021
AT1;AT12;AT124;30902;Amaliendorf-Aalfang;55_59;81;43;38;2021
AT1;AT12;AT124;30902;Amaliendorf-Aalfang;60_64;78;38;40;2021
AT1;AT12;AT124;30902;Amaliendorf-Aalfang;65_69;58;30;28;2021
AT1;AT12;AT124;30902;Amaliendorf-Aalfang;70_74;68;35;33;2021
AT1;AT12;AT124;30902;Amaliendorf-Aalfang;75_79;44;21;23;2021
AT1;AT12;AT124;30902;Amaliendorf-Aalfang;80_84;54;19;35;2021
AT1;AT12;AT124;30902;Amaliendorf-Aalfang;85_89;24;8;16;2021
AT1;AT12;AT124;30902;Amaliendorf-Aalfang;90_94;7;2;5;2021
AT1;AT12;AT124;30902;Amaliendorf-Aalfang;95_;1;0;1;2021
AT1;AT12;AT124;30903;Brand-Nagelberg;0_4;41;18;23;2021
AT1;AT12;AT124;30903;Brand-Nagelberg;5_9;53;24;29;2021
AT1;AT12;AT124;30903;Brand-Nagelberg;10_14;39;20;19;2021
AT1;AT12;AT124;30903;Brand-Nagelberg;15_19;60;28;32;2021
AT1;AT12;AT124;30903;Brand-Nagelberg;20_24;79;44;35;2021
AT1;AT12;AT124;30903;Brand-Nagelberg;25_29;89;47;42;2021
AT1;AT12;AT124;30903;Brand-Nagelberg;30_34;78;47;31;2021
AT1;AT12;AT124;30903;Brand-Nagelberg;35_39;75;42;33;2021
AT1;AT12;AT124;30903;Brand-Nagelberg;40_44;74;31;43;2021
AT1;AT12;AT124;30903;Brand-Nagelberg;45_49;98;49;49;2021
AT1;AT12;AT124;30903;Brand-Nagelberg;50_54;132;73;59;2021
AT1;AT12;AT124;30903;Brand-Nagelberg;55_59;122;67;55;2021
AT1;AT12;AT124;30903;Brand-Nagelberg;60_64;133;72;61;2021
AT1;AT12;AT124;30903;Brand-Nagelberg;65_69;110;55;55;2021
AT1;AT12;AT124;30903;Brand-Nagelberg;70_74;89;33;56;2021
AT1;AT12;AT124;30903;Brand-Nagelberg;75_79;72;38;34;2021
AT1;AT12;AT124;30903;Brand-Nagelberg;80_84;86;38;48;2021
AT1;AT12;AT124;30903;Brand-Nagelberg;85_89;30;11;19;2021
AT1;AT12;AT124;30903;Brand-Nagelberg;90_94;21;4;17;2021
AT1;AT12;AT124;30903;Brand-Nagelberg;95_;4;1;3;2021
AT1;AT12;AT124;30904;Eggern;0_4;30;16;14;2021
AT1;AT12;AT124;30904;Eggern;5_9;28;13;15;2021
AT1;AT12;AT124;30904;Eggern;10_14;29;17;12;2021
AT1;AT12;AT124;30904;Eggern;15_19;45;22;23;2021
AT1;AT12;AT124;30904;Eggern;20_24;31;16;15;2021
AT1;AT12;AT124;30904;Eggern;25_29;29;14;15;2021
AT1;AT12;AT124;30904;Eggern;30_34;32;16;16;2021
AT1;AT12;AT124;30904;Eggern;35_39;45;26;19;2021
AT1;AT12;AT124;30904;Eggern;40_44;39;20;19;2021
AT1;AT12;AT124;30904;Eggern;45_49;56;32;24;2021
AT1;AT12;AT124;30904;Eggern;50_54;56;30;26;2021
AT1;AT12;AT124;30904;Eggern;55_59;52;33;19;2021
AT1;AT12;AT124;30904;Eggern;60_64;47;23;24;2021
AT1;AT12;AT124;30904;Eggern;65_69;37;19;18;2021
AT1;AT12;AT124;30904;Eggern;70_74;33;16;17;2021
AT1;AT12;AT124;30904;Eggern;75_79;24;7;17;2021
AT1;AT12;AT124;30904;Eggern;80_84;36;18;18;2021
AT1;AT12;AT124;30904;Eggern;85_89;14;2;12;2021
AT1;AT12;AT124;30904;Eggern;90_94;5;0;5;2021
AT1;AT12;AT124;30904;Eggern;95_;0;0;0;2021
AT1;AT12;AT124;30906;Eisgarn;0_4;41;25;16;2021
AT1;AT12;AT124;30906;Eisgarn;5_9;27;11;16;2021
AT1;AT12;AT124;30906;Eisgarn;10_14;33;17;16;2021
AT1;AT12;AT124;30906;Eisgarn;15_19;28;18;10;2021
AT1;AT12;AT124;30906;Eisgarn;20_24;26;13;13;2021
AT1;AT12;AT124;30906;Eisgarn;25_29;36;19;17;2021
AT1;AT12;AT124;30906;Eisgarn;30_34;36;14;22;2021
AT1;AT12;AT124;30906;Eisgarn;35_39;39;23;16;2021
AT1;AT12;AT124;30906;Eisgarn;40_44;45;24;21;2021
AT1;AT12;AT124;30906;Eisgarn;45_49;30;13;17;2021
AT1;AT12;AT124;30906;Eisgarn;50_54;48;29;19;2021
AT1;AT12;AT124;30906;Eisgarn;55_59;59;31;28;2021
AT1;AT12;AT124;30906;Eisgarn;60_64;48;21;27;2021
AT1;AT12;AT124;30906;Eisgarn;65_69;55;24;31;2021
AT1;AT12;AT124;30906;Eisgarn;70_74;37;22;15;2021
AT1;AT12;AT124;30906;Eisgarn;75_79;36;22;14;2021
AT1;AT12;AT124;30906;Eisgarn;80_84;37;18;19;2021
AT1;AT12;AT124;30906;Eisgarn;85_89;19;9;10;2021
AT1;AT12;AT124;30906;Eisgarn;90_94;1;0;1;2021
AT1;AT12;AT124;30906;Eisgarn;95_;0;0;0;2021
AT1;AT12;AT124;30908;Gm�nd;0_4;227;116;111;2021
AT1;AT12;AT124;30908;Gm�nd;5_9;198;110;88;2021
AT1;AT12;AT124;30908;Gm�nd;10_14;205;107;98;2021
AT1;AT12;AT124;30908;Gm�nd;15_19;229;120;109;2021
AT1;AT12;AT124;30908;Gm�nd;20_24;246;131;115;2021
AT1;AT12;AT124;30908;Gm�nd;25_29;309;151;158;2021
AT1;AT12;AT124;30908;Gm�nd;30_34;282;163;119;2021
AT1;AT12;AT124;30908;Gm�nd;35_39;270;129;141;2021
AT1;AT12;AT124;30908;Gm�nd;40_44;254;127;127;2021
AT1;AT12;AT124;30908;Gm�nd;45_49;355;187;168;2021
AT1;AT12;AT124;30908;Gm�nd;50_54;403;188;215;2021
AT1;AT12;AT124;30908;Gm�nd;55_59;473;217;256;2021
AT1;AT12;AT124;30908;Gm�nd;60_64;424;226;198;2021
AT1;AT12;AT124;30908;Gm�nd;65_69;332;147;185;2021
AT1;AT12;AT124;30908;Gm�nd;70_74;317;140;177;2021
AT1;AT12;AT124;30908;Gm�nd;75_79;278;115;163;2021
AT1;AT12;AT124;30908;Gm�nd;80_84;257;113;144;2021
AT1;AT12;AT124;30908;Gm�nd;85_89;113;52;61;2021
AT1;AT12;AT124;30908;Gm�nd;90_94;49;13;36;2021
AT1;AT12;AT124;30908;Gm�nd;95_;17;4;13;2021
AT1;AT12;AT124;30909;Gro�dietmanns;0_4;101;59;42;2021
AT1;AT12;AT124;30909;Gro�dietmanns;5_9;115;62;53;2021
AT1;AT12;AT124;30909;Gro�dietmanns;10_14;72;35;37;2021
AT1;AT12;AT124;30909;Gro�dietmanns;15_19;114;59;55;2021
AT1;AT12;AT124;30909;Gro�dietmanns;20_24;110;61;49;2021
AT1;AT12;AT124;30909;Gro�dietmanns;25_29;104;58;46;2021
AT1;AT12;AT124;30909;Gro�dietmanns;30_34;115;58;57;2021
AT1;AT12;AT124;30909;Gro�dietmanns;35_39;146;57;89;2021
AT1;AT12;AT124;30909;Gro�dietmanns;40_44;120;69;51;2021
AT1;AT12;AT124;30909;Gro�dietmanns;45_49;151;74;77;2021
AT1;AT12;AT124;30909;Gro�dietmanns;50_54;206;102;104;2021
AT1;AT12;AT124;30909;Gro�dietmanns;55_59;214;114;100;2021
AT1;AT12;AT124;30909;Gro�dietmanns;60_64;151;75;76;2021
AT1;AT12;AT124;30909;Gro�dietmanns;65_69;136;70;66;2021
AT1;AT12;AT124;30909;Gro�dietmanns;70_74;113;58;55;2021
AT1;AT12;AT124;30909;Gro�dietmanns;75_79;76;43;33;2021
AT1;AT12;AT124;30909;Gro�dietmanns;80_84;100;45;55;2021
AT1;AT12;AT124;30909;Gro�dietmanns;85_89;48;21;27;2021
AT1;AT12;AT124;30909;Gro�dietmanns;90_94;12;4;8;2021
AT1;AT12;AT124;30909;Gro�dietmanns;95_;1;1;0;2021
AT1;AT12;AT124;30910;Bad Gro�pertholz;0_4;58;35;23;2021
AT1;AT12;AT124;30910;Bad Gro�pertholz;5_9;57;29;28;2021
AT1;AT12;AT124;30910;Bad Gro�pertholz;10_14;48;25;23;2021
AT1;AT12;AT124;30910;Bad Gro�pertholz;15_19;49;29;20;2021
AT1;AT12;AT124;30910;Bad Gro�pertholz;20_24;59;32;27;2021
AT1;AT12;AT124;30910;Bad Gro�pertholz;25_29;61;35;26;2021
AT1;AT12;AT124;30910;Bad Gro�pertholz;30_34;78;38;40;2021
AT1;AT12;AT124;30910;Bad Gro�pertholz;35_39;81;54;27;2021
AT1;AT12;AT124;30910;Bad Gro�pertholz;40_44;69;37;32;2021
AT1;AT12;AT124;30910;Bad Gro�pertholz;45_49;83;43;40;2021
AT1;AT12;AT124;30910;Bad Gro�pertholz;50_54;103;63;40;2021
AT1;AT12;AT124;30910;Bad Gro�pertholz;55_59;131;66;65;2021
AT1;AT12;AT124;30910;Bad Gro�pertholz;60_64;101;53;48;2021
AT1;AT12;AT124;30910;Bad Gro�pertholz;65_69;89;45;44;2021
AT1;AT12;AT124;30910;Bad Gro�pertholz;70_74;81;39;42;2021
AT1;AT12;AT124;30910;Bad Gro�pertholz;75_79;55;29;26;2021
AT1;AT12;AT124;30910;Bad Gro�pertholz;80_84;62;30;32;2021
AT1;AT12;AT124;30910;Bad Gro�pertholz;85_89;34;10;24;2021
AT1;AT12;AT124;30910;Bad Gro�pertholz;90_94;9;2;7;2021
AT1;AT12;AT124;30910;Bad Gro�pertholz;95_;0;0;0;2021
AT1;AT12;AT124;30912;Gro�sch�nau;0_4;72;38;34;2021
AT1;AT12;AT124;30912;Gro�sch�nau;5_9;70;37;33;2021
AT1;AT12;AT124;30912;Gro�sch�nau;10_14;53;32;21;2021
AT1;AT12;AT124;30912;Gro�sch�nau;15_19;68;33;35;2021
AT1;AT12;AT124;30912;Gro�sch�nau;20_24;64;32;32;2021
AT1;AT12;AT124;30912;Gro�sch�nau;25_29;71;39;32;2021
AT1;AT12;AT124;30912;Gro�sch�nau;30_34;64;30;34;2021
AT1;AT12;AT124;30912;Gro�sch�nau;35_39;93;50;43;2021
AT1;AT12;AT124;30912;Gro�sch�nau;40_44;74;41;33;2021
AT1;AT12;AT124;30912;Gro�sch�nau;45_49;87;44;43;2021
AT1;AT12;AT124;30912;Gro�sch�nau;50_54;73;41;32;2021
AT1;AT12;AT124;30912;Gro�sch�nau;55_59;102;51;51;2021
AT1;AT12;AT124;30912;Gro�sch�nau;60_64;94;50;44;2021
AT1;AT12;AT124;30912;Gro�sch�nau;65_69;69;34;35;2021
AT1;AT12;AT124;30912;Gro�sch�nau;70_74;62;26;36;2021
AT1;AT12;AT124;30912;Gro�sch�nau;75_79;42;22;20;2021
AT1;AT12;AT124;30912;Gro�sch�nau;80_84;29;11;18;2021
AT1;AT12;AT124;30912;Gro�sch�nau;85_89;26;10;16;2021
AT1;AT12;AT124;30912;Gro�sch�nau;90_94;7;4;3;2021
AT1;AT12;AT124;30912;Gro�sch�nau;95_;1;0;1;2021
AT1;AT12;AT124;30913;Moorbad Harbach;0_4;27;18;9;2021
AT1;AT12;AT124;30913;Moorbad Harbach;5_9;35;20;15;2021
AT1;AT12;AT124;30913;Moorbad Harbach;10_14;34;17;17;2021
AT1;AT12;AT124;30913;Moorbad Harbach;15_19;42;16;26;2021
AT1;AT12;AT124;30913;Moorbad Harbach;20_24;38;22;16;2021
AT1;AT12;AT124;30913;Moorbad Harbach;25_29;42;24;18;2021
AT1;AT12;AT124;30913;Moorbad Harbach;30_34;36;23;13;2021
AT1;AT12;AT124;30913;Moorbad Harbach;35_39;39;20;19;2021
AT1;AT12;AT124;30913;Moorbad Harbach;40_44;48;25;23;2021
AT1;AT12;AT124;30913;Moorbad Harbach;45_49;58;27;31;2021
AT1;AT12;AT124;30913;Moorbad Harbach;50_54;51;32;19;2021
AT1;AT12;AT124;30913;Moorbad Harbach;55_59;61;26;35;2021
AT1;AT12;AT124;30913;Moorbad Harbach;60_64;61;28;33;2021
AT1;AT12;AT124;30913;Moorbad Harbach;65_69;45;28;17;2021
AT1;AT12;AT124;30913;Moorbad Harbach;70_74;37;18;19;2021
AT1;AT12;AT124;30913;Moorbad Harbach;75_79;21;11;10;2021
AT1;AT12;AT124;30913;Moorbad Harbach;80_84;29;13;16;2021
AT1;AT12;AT124;30913;Moorbad Harbach;85_89;13;6;7;2021
AT1;AT12;AT124;30913;Moorbad Harbach;90_94;4;1;3;2021
AT1;AT12;AT124;30913;Moorbad Harbach;95_;0;0;0;2021
AT1;AT12;AT124;30915;Haugschlag;0_4;14;9;5;2021
AT1;AT12;AT124;30915;Haugschlag;5_9;29;17;12;2021
AT1;AT12;AT124;30915;Haugschlag;10_14;21;13;8;2021
AT1;AT12;AT124;30915;Haugschlag;15_19;31;16;15;2021
AT1;AT12;AT124;30915;Haugschlag;20_24;23;14;9;2021
AT1;AT12;AT124;30915;Haugschlag;25_29;14;6;8;2021
AT1;AT12;AT124;30915;Haugschlag;30_34;18;7;11;2021
AT1;AT12;AT124;30915;Haugschlag;35_39;26;12;14;2021
AT1;AT12;AT124;30915;Haugschlag;40_44;25;11;14;2021
AT1;AT12;AT124;30915;Haugschlag;45_49;32;19;13;2021
AT1;AT12;AT124;30915;Haugschlag;50_54;45;29;16;2021
AT1;AT12;AT124;30915;Haugschlag;55_59;32;17;15;2021
AT1;AT12;AT124;30915;Haugschlag;60_64;33;16;17;2021
AT1;AT12;AT124;30915;Haugschlag;65_69;42;28;14;2021
AT1;AT12;AT124;30915;Haugschlag;70_74;24;9;15;2021
AT1;AT12;AT124;30915;Haugschlag;75_79;24;12;12;2021
AT1;AT12;AT124;30915;Haugschlag;80_84;23;8;15;2021
AT1;AT12;AT124;30915;Haugschlag;85_89;13;3;10;2021
AT1;AT12;AT124;30915;Haugschlag;90_94;5;2;3;2021
AT1;AT12;AT124;30915;Haugschlag;95_;1;0;1;2021
AT1;AT12;AT124;30916;Heidenreichstein;0_4;148;68;80;2021
AT1;AT12;AT124;30916;Heidenreichstein;5_9;136;71;65;2021
AT1;AT12;AT124;30916;Heidenreichstein;10_14;143;71;72;2021
AT1;AT12;AT124;30916;Heidenreichstein;15_19;158;73;85;2021
AT1;AT12;AT124;30916;Heidenreichstein;20_24;186;107;79;2021
AT1;AT12;AT124;30916;Heidenreichstein;25_29;230;127;103;2021
AT1;AT12;AT124;30916;Heidenreichstein;30_34;191;105;86;2021
AT1;AT12;AT124;30916;Heidenreichstein;35_39;199;95;104;2021
AT1;AT12;AT124;30916;Heidenreichstein;40_44;200;104;96;2021
AT1;AT12;AT124;30916;Heidenreichstein;45_49;257;127;130;2021
AT1;AT12;AT124;30916;Heidenreichstein;50_54;310;163;147;2021
AT1;AT12;AT124;30916;Heidenreichstein;55_59;341;167;174;2021
AT1;AT12;AT124;30916;Heidenreichstein;60_64;281;152;129;2021
AT1;AT12;AT124;30916;Heidenreichstein;65_69;275;132;143;2021
AT1;AT12;AT124;30916;Heidenreichstein;70_74;240;105;135;2021
AT1;AT12;AT124;30916;Heidenreichstein;75_79;215;94;121;2021
AT1;AT12;AT124;30916;Heidenreichstein;80_84;212;85;127;2021
AT1;AT12;AT124;30916;Heidenreichstein;85_89;103;40;63;2021
AT1;AT12;AT124;30916;Heidenreichstein;90_94;49;19;30;2021
AT1;AT12;AT124;30916;Heidenreichstein;95_;8;2;6;2021
AT1;AT12;AT124;30917;Hirschbach;0_4;26;15;11;2021
AT1;AT12;AT124;30917;Hirschbach;5_9;28;15;13;2021
AT1;AT12;AT124;30917;Hirschbach;10_14;20;9;11;2021
AT1;AT12;AT124;30917;Hirschbach;15_19;26;13;13;2021
AT1;AT12;AT124;30917;Hirschbach;20_24;34;19;15;2021
AT1;AT12;AT124;30917;Hirschbach;25_29;34;19;15;2021
AT1;AT12;AT124;30917;Hirschbach;30_34;35;18;17;2021
AT1;AT12;AT124;30917;Hirschbach;35_39;40;21;19;2021
AT1;AT12;AT124;30917;Hirschbach;40_44;27;14;13;2021
AT1;AT12;AT124;30917;Hirschbach;45_49;58;32;26;2021
AT1;AT12;AT124;30917;Hirschbach;50_54;43;17;26;2021
AT1;AT12;AT124;30917;Hirschbach;55_59;41;20;21;2021
AT1;AT12;AT124;30917;Hirschbach;60_64;55;27;28;2021
AT1;AT12;AT124;30917;Hirschbach;65_69;31;17;14;2021
AT1;AT12;AT124;30917;Hirschbach;70_74;31;13;18;2021
AT1;AT12;AT124;30917;Hirschbach;75_79;28;14;14;2021
AT1;AT12;AT124;30917;Hirschbach;80_84;18;7;11;2021
AT1;AT12;AT124;30917;Hirschbach;85_89;7;4;3;2021
AT1;AT12;AT124;30917;Hirschbach;90_94;3;1;2;2021
AT1;AT12;AT124;30917;Hirschbach;95_;1;0;1;2021
AT1;AT12;AT124;30920;Hoheneich;0_4;39;22;17;2021
AT1;AT12;AT124;30920;Hoheneich;5_9;50;26;24;2021
AT1;AT12;AT124;30920;Hoheneich;10_14;49;17;32;2021
AT1;AT12;AT124;30920;Hoheneich;15_19;62;27;35;2021
AT1;AT12;AT124;30920;Hoheneich;20_24;81;39;42;2021
AT1;AT12;AT124;30920;Hoheneich;25_29;68;42;26;2021
AT1;AT12;AT124;30920;Hoheneich;30_34;74;39;35;2021
AT1;AT12;AT124;30920;Hoheneich;35_39;59;30;29;2021
AT1;AT12;AT124;30920;Hoheneich;40_44;75;38;37;2021
AT1;AT12;AT124;30920;Hoheneich;45_49;91;48;43;2021
AT1;AT12;AT124;30920;Hoheneich;50_54;122;55;67;2021
AT1;AT12;AT124;30920;Hoheneich;55_59;137;73;64;2021
AT1;AT12;AT124;30920;Hoheneich;60_64;108;62;46;2021
AT1;AT12;AT124;30920;Hoheneich;65_69;97;45;52;2021
AT1;AT12;AT124;30920;Hoheneich;70_74;97;45;52;2021
AT1;AT12;AT124;30920;Hoheneich;75_79;84;38;46;2021
AT1;AT12;AT124;30920;Hoheneich;80_84;55;30;25;2021
AT1;AT12;AT124;30920;Hoheneich;85_89;32;9;23;2021
AT1;AT12;AT124;30920;Hoheneich;90_94;7;3;4;2021
AT1;AT12;AT124;30920;Hoheneich;95_;2;0;2;2021
AT1;AT12;AT124;30921;Kirchberg am Walde;0_4;48;15;33;2021
AT1;AT12;AT124;30921;Kirchberg am Walde;5_9;59;31;28;2021
AT1;AT12;AT124;30921;Kirchberg am Walde;10_14;82;43;39;2021
AT1;AT12;AT124;30921;Kirchberg am Walde;15_19;67;34;33;2021
AT1;AT12;AT124;30921;Kirchberg am Walde;20_24;67;37;30;2021
AT1;AT12;AT124;30921;Kirchberg am Walde;25_29;67;38;29;2021
AT1;AT12;AT124;30921;Kirchberg am Walde;30_34;67;34;33;2021
AT1;AT12;AT124;30921;Kirchberg am Walde;35_39;80;39;41;2021
AT1;AT12;AT124;30921;Kirchberg am Walde;40_44;74;38;36;2021
AT1;AT12;AT124;30921;Kirchberg am Walde;45_49;81;40;41;2021
AT1;AT12;AT124;30921;Kirchberg am Walde;50_54;89;42;47;2021
AT1;AT12;AT124;30921;Kirchberg am Walde;55_59;119;60;59;2021
AT1;AT12;AT124;30921;Kirchberg am Walde;60_64;99;57;42;2021
AT1;AT12;AT124;30921;Kirchberg am Walde;65_69;77;38;39;2021
AT1;AT12;AT124;30921;Kirchberg am Walde;70_74;66;35;31;2021
AT1;AT12;AT124;30921;Kirchberg am Walde;75_79;48;24;24;2021
AT1;AT12;AT124;30921;Kirchberg am Walde;80_84;71;25;46;2021
AT1;AT12;AT124;30921;Kirchberg am Walde;85_89;33;13;20;2021
AT1;AT12;AT124;30921;Kirchberg am Walde;90_94;10;2;8;2021
AT1;AT12;AT124;30921;Kirchberg am Walde;95_;1;0;1;2021
AT1;AT12;AT124;30925;Litschau;0_4;85;36;49;2021
AT1;AT12;AT124;30925;Litschau;5_9;60;25;35;2021
AT1;AT12;AT124;30925;Litschau;10_14;65;31;34;2021
AT1;AT12;AT124;30925;Litschau;15_19;86;52;34;2021
AT1;AT12;AT124;30925;Litschau;20_24;89;57;32;2021
AT1;AT12;AT124;30925;Litschau;25_29;97;52;45;2021
AT1;AT12;AT124;30925;Litschau;30_34;93;50;43;2021
AT1;AT12;AT124;30925;Litschau;35_39;118;60;58;2021
AT1;AT12;AT124;30925;Litschau;40_44;110;64;46;2021
AT1;AT12;AT124;30925;Litschau;45_49;134;68;66;2021
AT1;AT12;AT124;30925;Litschau;50_54;166;85;81;2021
AT1;AT12;AT124;30925;Litschau;55_59;178;85;93;2021
AT1;AT12;AT124;30925;Litschau;60_64;208;109;99;2021
AT1;AT12;AT124;30925;Litschau;65_69;185;99;86;2021
AT1;AT12;AT124;30925;Litschau;70_74;162;76;86;2021
AT1;AT12;AT124;30925;Litschau;75_79;118;61;57;2021
AT1;AT12;AT124;30925;Litschau;80_84;100;32;68;2021
AT1;AT12;AT124;30925;Litschau;85_89;85;31;54;2021
AT1;AT12;AT124;30925;Litschau;90_94;44;8;36;2021
AT1;AT12;AT124;30925;Litschau;95_;9;0;9;2021
AT1;AT12;AT124;30929;Reingers;0_4;20;12;8;2021
AT1;AT12;AT124;30929;Reingers;5_9;28;13;15;2021
AT1;AT12;AT124;30929;Reingers;10_14;23;11;12;2021
AT1;AT12;AT124;30929;Reingers;15_19;32;21;11;2021
AT1;AT12;AT124;30929;Reingers;20_24;41;20;21;2021
AT1;AT12;AT124;30929;Reingers;25_29;22;14;8;2021
AT1;AT12;AT124;30929;Reingers;30_34;29;15;14;2021
AT1;AT12;AT124;30929;Reingers;35_39;37;18;19;2021
AT1;AT12;AT124;30929;Reingers;40_44;29;19;10;2021
AT1;AT12;AT124;30929;Reingers;45_49;51;28;23;2021
AT1;AT12;AT124;30929;Reingers;50_54;58;30;28;2021
AT1;AT12;AT124;30929;Reingers;55_59;52;27;25;2021
AT1;AT12;AT124;30929;Reingers;60_64;56;34;22;2021
AT1;AT12;AT124;30929;Reingers;65_69;28;13;15;2021
AT1;AT12;AT124;30929;Reingers;70_74;42;25;17;2021
AT1;AT12;AT124;30929;Reingers;75_79;22;11;11;2021
AT1;AT12;AT124;30929;Reingers;80_84;29;8;21;2021
AT1;AT12;AT124;30929;Reingers;85_89;16;8;8;2021
AT1;AT12;AT124;30929;Reingers;90_94;1;0;1;2021
AT1;AT12;AT124;30929;Reingers;95_;0;0;0;2021
AT1;AT12;AT124;30932;St. Martin;0_4;43;22;21;2021
AT1;AT12;AT124;30932;St. Martin;5_9;60;28;32;2021
AT1;AT12;AT124;30932;St. Martin;10_14;43;22;21;2021
AT1;AT12;AT124;30932;St. Martin;15_19;51;29;22;2021
AT1;AT12;AT124;30932;St. Martin;20_24;54;27;27;2021
AT1;AT12;AT124;30932;St. Martin;25_29;46;26;20;2021
AT1;AT12;AT124;30932;St. Martin;30_34;60;32;28;2021
AT1;AT12;AT124;30932;St. Martin;35_39;66;32;34;2021
AT1;AT12;AT124;30932;St. Martin;40_44;56;27;29;2021
AT1;AT12;AT124;30932;St. Martin;45_49;78;40;38;2021
AT1;AT12;AT124;30932;St. Martin;50_54;101;50;51;2021
AT1;AT12;AT124;30932;St. Martin;55_59;108;63;45;2021
AT1;AT12;AT124;30932;St. Martin;60_64;74;37;37;2021
AT1;AT12;AT124;30932;St. Martin;65_69;64;29;35;2021
AT1;AT12;AT124;30932;St. Martin;70_74;59;34;25;2021
AT1;AT12;AT124;30932;St. Martin;75_79;32;9;23;2021
AT1;AT12;AT124;30932;St. Martin;80_84;43;16;27;2021
AT1;AT12;AT124;30932;St. Martin;85_89;28;6;22;2021
AT1;AT12;AT124;30932;St. Martin;90_94;7;2;5;2021
AT1;AT12;AT124;30932;St. Martin;95_;1;0;1;2021
AT1;AT12;AT124;30935;Schrems;0_4;198;109;89;2021
AT1;AT12;AT124;30935;Schrems;5_9;230;115;115;2021
AT1;AT12;AT124;30935;Schrems;10_14;213;115;98;2021
AT1;AT12;AT124;30935;Schrems;15_19;245;129;116;2021
AT1;AT12;AT124;30935;Schrems;20_24;286;149;137;2021
AT1;AT12;AT124;30935;Schrems;25_29;287;143;144;2021
AT1;AT12;AT124;30935;Schrems;30_34;285;142;143;2021
AT1;AT12;AT124;30935;Schrems;35_39;308;163;145;2021
AT1;AT12;AT124;30935;Schrems;40_44;285;145;140;2021
AT1;AT12;AT124;30935;Schrems;45_49;326;158;168;2021
AT1;AT12;AT124;30935;Schrems;50_54;441;229;212;2021
AT1;AT12;AT124;30935;Schrems;55_59;455;230;225;2021
AT1;AT12;AT124;30935;Schrems;60_64;424;198;226;2021
AT1;AT12;AT124;30935;Schrems;65_69;345;166;179;2021
AT1;AT12;AT124;30935;Schrems;70_74;338;154;184;2021
AT1;AT12;AT124;30935;Schrems;75_79;230;101;129;2021
AT1;AT12;AT124;30935;Schrems;80_84;255;99;156;2021
AT1;AT12;AT124;30935;Schrems;85_89;141;43;98;2021
AT1;AT12;AT124;30935;Schrems;90_94;53;14;39;2021
AT1;AT12;AT124;30935;Schrems;95_;11;1;10;2021
AT1;AT12;AT124;30939;Unserfrau-Altweitra;0_4;44;22;22;2021
AT1;AT12;AT124;30939;Unserfrau-Altweitra;5_9;44;16;28;2021
AT1;AT12;AT124;30939;Unserfrau-Altweitra;10_14;49;33;16;2021
AT1;AT12;AT124;30939;Unserfrau-Altweitra;15_19;60;30;30;2021
AT1;AT12;AT124;30939;Unserfrau-Altweitra;20_24;57;27;30;2021
AT1;AT12;AT124;30939;Unserfrau-Altweitra;25_29;57;35;22;2021
AT1;AT12;AT124;30939;Unserfrau-Altweitra;30_34;43;27;16;2021
AT1;AT12;AT124;30939;Unserfrau-Altweitra;35_39;64;27;37;2021
AT1;AT12;AT124;30939;Unserfrau-Altweitra;40_44;59;30;29;2021
AT1;AT12;AT124;30939;Unserfrau-Altweitra;45_49;71;33;38;2021
AT1;AT12;AT124;30939;Unserfrau-Altweitra;50_54;87;47;40;2021
AT1;AT12;AT124;30939;Unserfrau-Altweitra;55_59;75;43;32;2021
AT1;AT12;AT124;30939;Unserfrau-Altweitra;60_64;69;38;31;2021
AT1;AT12;AT124;30939;Unserfrau-Altweitra;65_69;51;29;22;2021
AT1;AT12;AT124;30939;Unserfrau-Altweitra;70_74;58;23;35;2021
AT1;AT12;AT124;30939;Unserfrau-Altweitra;75_79;34;12;22;2021
AT1;AT12;AT124;30939;Unserfrau-Altweitra;80_84;33;15;18;2021
AT1;AT12;AT124;30939;Unserfrau-Altweitra;85_89;23;10;13;2021
AT1;AT12;AT124;30939;Unserfrau-Altweitra;90_94;9;3;6;2021
AT1;AT12;AT124;30939;Unserfrau-Altweitra;95_;1;0;1;2021
AT1;AT12;AT124;30940;Waldenstein;0_4;56;28;28;2021
AT1;AT12;AT124;30940;Waldenstein;5_9;60;29;31;2021
AT1;AT12;AT124;30940;Waldenstein;10_14;59;32;27;2021
AT1;AT12;AT124;30940;Waldenstein;15_19;52;32;20;2021
AT1;AT12;AT124;30940;Waldenstein;20_24;67;37;30;2021
AT1;AT12;AT124;30940;Waldenstein;25_29;81;43;38;2021
AT1;AT12;AT124;30940;Waldenstein;30_34;70;33;37;2021
AT1;AT12;AT124;30940;Waldenstein;35_39;76;38;38;2021
AT1;AT12;AT124;30940;Waldenstein;40_44;72;42;30;2021
AT1;AT12;AT124;30940;Waldenstein;45_49;104;55;49;2021
AT1;AT12;AT124;30940;Waldenstein;50_54;100;48;52;2021
AT1;AT12;AT124;30940;Waldenstein;55_59;114;60;54;2021
AT1;AT12;AT124;30940;Waldenstein;60_64;66;36;30;2021
AT1;AT12;AT124;30940;Waldenstein;65_69;55;25;30;2021
AT1;AT12;AT124;30940;Waldenstein;70_74;36;20;16;2021
AT1;AT12;AT124;30940;Waldenstein;75_79;38;18;20;2021
AT1;AT12;AT124;30940;Waldenstein;80_84;41;13;28;2021
AT1;AT12;AT124;30940;Waldenstein;85_89;22;10;12;2021
AT1;AT12;AT124;30940;Waldenstein;90_94;8;3;5;2021
AT1;AT12;AT124;30940;Waldenstein;95_;1;0;1;2021
AT1;AT12;AT124;30942;Weitra;0_4;109;45;64;2021
AT1;AT12;AT124;30942;Weitra;5_9;111;67;44;2021
AT1;AT12;AT124;30942;Weitra;10_14;106;50;56;2021
AT1;AT12;AT124;30942;Weitra;15_19;126;62;64;2021
AT1;AT12;AT124;30942;Weitra;20_24;122;79;43;2021
AT1;AT12;AT124;30942;Weitra;25_29;124;68;56;2021
AT1;AT12;AT124;30942;Weitra;30_34;139;65;74;2021
AT1;AT12;AT124;30942;Weitra;35_39;142;71;71;2021
AT1;AT12;AT124;30942;Weitra;40_44;144;74;70;2021
AT1;AT12;AT124;30942;Weitra;45_49;175;81;94;2021
AT1;AT12;AT124;30942;Weitra;50_54;219;111;108;2021
AT1;AT12;AT124;30942;Weitra;55_59;222;105;117;2021
AT1;AT12;AT124;30942;Weitra;60_64;182;104;78;2021
AT1;AT12;AT124;30942;Weitra;65_69;166;84;82;2021
AT1;AT12;AT124;30942;Weitra;70_74;145;62;83;2021
AT1;AT12;AT124;30942;Weitra;75_79;135;64;71;2021
AT1;AT12;AT124;30942;Weitra;80_84;125;50;75;2021
AT1;AT12;AT124;30942;Weitra;85_89;88;33;55;2021
AT1;AT12;AT124;30942;Weitra;90_94;40;13;27;2021
AT1;AT12;AT124;30942;Weitra;95_;9;1;8;2021
AT1;AT12;AT125;31001;Alberndorf im Pulkautal;0_4;34;18;16;2021
AT1;AT12;AT125;31001;Alberndorf im Pulkautal;5_9;38;16;22;2021
AT1;AT12;AT125;31001;Alberndorf im Pulkautal;10_14;36;15;21;2021
AT1;AT12;AT125;31001;Alberndorf im Pulkautal;15_19;23;9;14;2021
AT1;AT12;AT125;31001;Alberndorf im Pulkautal;20_24;41;16;25;2021
AT1;AT12;AT125;31001;Alberndorf im Pulkautal;25_29;31;19;12;2021
AT1;AT12;AT125;31001;Alberndorf im Pulkautal;30_34;51;27;24;2021
AT1;AT12;AT125;31001;Alberndorf im Pulkautal;35_39;38;19;19;2021
AT1;AT12;AT125;31001;Alberndorf im Pulkautal;40_44;38;21;17;2021
AT1;AT12;AT125;31001;Alberndorf im Pulkautal;45_49;63;28;35;2021
AT1;AT12;AT125;31001;Alberndorf im Pulkautal;50_54;48;25;23;2021
AT1;AT12;AT125;31001;Alberndorf im Pulkautal;55_59;63;27;36;2021
AT1;AT12;AT125;31001;Alberndorf im Pulkautal;60_64;64;35;29;2021
AT1;AT12;AT125;31001;Alberndorf im Pulkautal;65_69;53;30;23;2021
AT1;AT12;AT125;31001;Alberndorf im Pulkautal;70_74;49;27;22;2021
AT1;AT12;AT125;31001;Alberndorf im Pulkautal;75_79;22;10;12;2021
AT1;AT12;AT125;31001;Alberndorf im Pulkautal;80_84;28;10;18;2021
AT1;AT12;AT125;31001;Alberndorf im Pulkautal;85_89;21;12;9;2021
AT1;AT12;AT125;31001;Alberndorf im Pulkautal;90_94;4;1;3;2021
AT1;AT12;AT125;31001;Alberndorf im Pulkautal;95_;0;0;0;2021
AT1;AT12;AT125;31008;G�llersdorf;0_4;133;63;70;2021
AT1;AT12;AT125;31008;G�llersdorf;5_9;132;61;71;2021
AT1;AT12;AT125;31008;G�llersdorf;10_14;150;64;86;2021
AT1;AT12;AT125;31008;G�llersdorf;15_19;155;75;80;2021
AT1;AT12;AT125;31008;G�llersdorf;20_24;132;78;54;2021
AT1;AT12;AT125;31008;G�llersdorf;25_29;156;84;72;2021
AT1;AT12;AT125;31008;G�llersdorf;30_34;196;116;80;2021
AT1;AT12;AT125;31008;G�llersdorf;35_39;197;111;86;2021
AT1;AT12;AT125;31008;G�llersdorf;40_44;210;100;110;2021
AT1;AT12;AT125;31008;G�llersdorf;45_49;255;144;111;2021
AT1;AT12;AT125;31008;G�llersdorf;50_54;258;136;122;2021
AT1;AT12;AT125;31008;G�llersdorf;55_59;279;129;150;2021
AT1;AT12;AT125;31008;G�llersdorf;60_64;246;129;117;2021
AT1;AT12;AT125;31008;G�llersdorf;65_69;192;97;95;2021
AT1;AT12;AT125;31008;G�llersdorf;70_74;158;83;75;2021
AT1;AT12;AT125;31008;G�llersdorf;75_79;87;36;51;2021
AT1;AT12;AT125;31008;G�llersdorf;80_84;99;48;51;2021
AT1;AT12;AT125;31008;G�llersdorf;85_89;51;17;34;2021
AT1;AT12;AT125;31008;G�llersdorf;90_94;21;6;15;2021
AT1;AT12;AT125;31008;G�llersdorf;95_;5;0;5;2021
AT1;AT12;AT125;31009;Grabern;0_4;96;50;46;2021
AT1;AT12;AT125;31009;Grabern;5_9;100;47;53;2021
AT1;AT12;AT125;31009;Grabern;10_14;99;57;42;2021
AT1;AT12;AT125;31009;Grabern;15_19;106;46;60;2021
AT1;AT12;AT125;31009;Grabern;20_24;66;39;27;2021
AT1;AT12;AT125;31009;Grabern;25_29;102;43;59;2021
AT1;AT12;AT125;31009;Grabern;30_34;121;63;58;2021
AT1;AT12;AT125;31009;Grabern;35_39;120;55;65;2021
AT1;AT12;AT125;31009;Grabern;40_44;134;71;63;2021
AT1;AT12;AT125;31009;Grabern;45_49;126;57;69;2021
AT1;AT12;AT125;31009;Grabern;50_54;130;68;62;2021
AT1;AT12;AT125;31009;Grabern;55_59;132;74;58;2021
AT1;AT12;AT125;31009;Grabern;60_64;120;57;63;2021
AT1;AT12;AT125;31009;Grabern;65_69;94;42;52;2021
AT1;AT12;AT125;31009;Grabern;70_74;69;37;32;2021
AT1;AT12;AT125;31009;Grabern;75_79;31;13;18;2021
AT1;AT12;AT125;31009;Grabern;80_84;56;20;36;2021
AT1;AT12;AT125;31009;Grabern;85_89;23;7;16;2021
AT1;AT12;AT125;31009;Grabern;90_94;9;1;8;2021
AT1;AT12;AT125;31009;Grabern;95_;0;0;0;2021
AT1;AT12;AT125;31014;Guntersdorf;0_4;47;26;21;2021
AT1;AT12;AT125;31014;Guntersdorf;5_9;54;27;27;2021
AT1;AT12;AT125;31014;Guntersdorf;10_14;52;33;19;2021
AT1;AT12;AT125;31014;Guntersdorf;15_19;60;32;28;2021
AT1;AT12;AT125;31014;Guntersdorf;20_24;51;34;17;2021
AT1;AT12;AT125;31014;Guntersdorf;25_29;71;37;34;2021
AT1;AT12;AT125;31014;Guntersdorf;30_34;61;32;29;2021
AT1;AT12;AT125;31014;Guntersdorf;35_39;67;30;37;2021
AT1;AT12;AT125;31014;Guntersdorf;40_44;80;39;41;2021
AT1;AT12;AT125;31014;Guntersdorf;45_49;81;37;44;2021
AT1;AT12;AT125;31014;Guntersdorf;50_54;106;59;47;2021
AT1;AT12;AT125;31014;Guntersdorf;55_59;97;39;58;2021
AT1;AT12;AT125;31014;Guntersdorf;60_64;92;51;41;2021
AT1;AT12;AT125;31014;Guntersdorf;65_69;68;38;30;2021
AT1;AT12;AT125;31014;Guntersdorf;70_74;52;22;30;2021
AT1;AT12;AT125;31014;Guntersdorf;75_79;42;22;20;2021
AT1;AT12;AT125;31014;Guntersdorf;80_84;38;14;24;2021
AT1;AT12;AT125;31014;Guntersdorf;85_89;26;14;12;2021
AT1;AT12;AT125;31014;Guntersdorf;90_94;11;3;8;2021
AT1;AT12;AT125;31014;Guntersdorf;95_;0;0;0;2021
AT1;AT12;AT125;31015;Hadres;0_4;70;32;38;2021
AT1;AT12;AT125;31015;Hadres;5_9;80;40;40;2021
AT1;AT12;AT125;31015;Hadres;10_14;59;34;25;2021
AT1;AT12;AT125;31015;Hadres;15_19;74;42;32;2021
AT1;AT12;AT125;31015;Hadres;20_24;81;42;39;2021
AT1;AT12;AT125;31015;Hadres;25_29;83;47;36;2021
AT1;AT12;AT125;31015;Hadres;30_34;106;53;53;2021
AT1;AT12;AT125;31015;Hadres;35_39;109;58;51;2021
AT1;AT12;AT125;31015;Hadres;40_44;76;40;36;2021
AT1;AT12;AT125;31015;Hadres;45_49;112;51;61;2021
AT1;AT12;AT125;31015;Hadres;50_54;141;77;64;2021
AT1;AT12;AT125;31015;Hadres;55_59;168;78;90;2021
AT1;AT12;AT125;31015;Hadres;60_64;148;80;68;2021
AT1;AT12;AT125;31015;Hadres;65_69;114;58;56;2021
AT1;AT12;AT125;31015;Hadres;70_74;91;36;55;2021
AT1;AT12;AT125;31015;Hadres;75_79;73;38;35;2021
AT1;AT12;AT125;31015;Hadres;80_84;67;27;40;2021
AT1;AT12;AT125;31015;Hadres;85_89;31;8;23;2021
AT1;AT12;AT125;31015;Hadres;90_94;16;1;15;2021
AT1;AT12;AT125;31015;Hadres;95_;4;0;4;2021
AT1;AT12;AT125;31016;Hardegg;0_4;54;22;32;2021
AT1;AT12;AT125;31016;Hardegg;5_9;60;31;29;2021
AT1;AT12;AT125;31016;Hardegg;10_14;37;15;22;2021
AT1;AT12;AT125;31016;Hardegg;15_19;61;26;35;2021
AT1;AT12;AT125;31016;Hardegg;20_24;57;31;26;2021
AT1;AT12;AT125;31016;Hardegg;25_29;62;28;34;2021
AT1;AT12;AT125;31016;Hardegg;30_34;52;27;25;2021
AT1;AT12;AT125;31016;Hardegg;35_39;59;28;31;2021
AT1;AT12;AT125;31016;Hardegg;40_44;77;45;32;2021
AT1;AT12;AT125;31016;Hardegg;45_49;86;44;42;2021
AT1;AT12;AT125;31016;Hardegg;50_54;114;63;51;2021
AT1;AT12;AT125;31016;Hardegg;55_59;130;70;60;2021
AT1;AT12;AT125;31016;Hardegg;60_64;111;56;55;2021
AT1;AT12;AT125;31016;Hardegg;65_69;92;46;46;2021
AT1;AT12;AT125;31016;Hardegg;70_74;84;44;40;2021
AT1;AT12;AT125;31016;Hardegg;75_79;67;29;38;2021
AT1;AT12;AT125;31016;Hardegg;80_84;55;23;32;2021
AT1;AT12;AT125;31016;Hardegg;85_89;30;9;21;2021
AT1;AT12;AT125;31016;Hardegg;90_94;15;4;11;2021
AT1;AT12;AT125;31016;Hardegg;95_;6;2;4;2021
AT1;AT12;AT125;31018;Haugsdorf;0_4;62;34;28;2021
AT1;AT12;AT125;31018;Haugsdorf;5_9;72;36;36;2021
AT1;AT12;AT125;31018;Haugsdorf;10_14;74;44;30;2021
AT1;AT12;AT125;31018;Haugsdorf;15_19;66;39;27;2021
AT1;AT12;AT125;31018;Haugsdorf;20_24;73;35;38;2021
AT1;AT12;AT125;31018;Haugsdorf;25_29;79;41;38;2021
AT1;AT12;AT125;31018;Haugsdorf;30_34;71;40;31;2021
AT1;AT12;AT125;31018;Haugsdorf;35_39;82;35;47;2021
AT1;AT12;AT125;31018;Haugsdorf;40_44;91;46;45;2021
AT1;AT12;AT125;31018;Haugsdorf;45_49;123;63;60;2021
AT1;AT12;AT125;31018;Haugsdorf;50_54;117;65;52;2021
AT1;AT12;AT125;31018;Haugsdorf;55_59;127;62;65;2021
AT1;AT12;AT125;31018;Haugsdorf;60_64;131;66;65;2021
AT1;AT12;AT125;31018;Haugsdorf;65_69;117;56;61;2021
AT1;AT12;AT125;31018;Haugsdorf;70_74;106;52;54;2021
AT1;AT12;AT125;31018;Haugsdorf;75_79;74;36;38;2021
AT1;AT12;AT125;31018;Haugsdorf;80_84;72;32;40;2021
AT1;AT12;AT125;31018;Haugsdorf;85_89;38;16;22;2021
AT1;AT12;AT125;31018;Haugsdorf;90_94;19;8;11;2021
AT1;AT12;AT125;31018;Haugsdorf;95_;3;1;2;2021
AT1;AT12;AT125;31019;Heldenberg;0_4;95;45;50;2021
AT1;AT12;AT125;31019;Heldenberg;5_9;85;46;39;2021
AT1;AT12;AT125;31019;Heldenberg;10_14;65;36;29;2021
AT1;AT12;AT125;31019;Heldenberg;15_19;60;32;28;2021
AT1;AT12;AT125;31019;Heldenberg;20_24;57;34;23;2021
AT1;AT12;AT125;31019;Heldenberg;25_29;68;34;34;2021
AT1;AT12;AT125;31019;Heldenberg;30_34;103;41;62;2021
AT1;AT12;AT125;31019;Heldenberg;35_39;107;59;48;2021
AT1;AT12;AT125;31019;Heldenberg;40_44;91;47;44;2021
AT1;AT12;AT125;31019;Heldenberg;45_49;105;57;48;2021
AT1;AT12;AT125;31019;Heldenberg;50_54;97;55;42;2021
AT1;AT12;AT125;31019;Heldenberg;55_59;117;52;65;2021
AT1;AT12;AT125;31019;Heldenberg;60_64;100;58;42;2021
AT1;AT12;AT125;31019;Heldenberg;65_69;72;27;45;2021
AT1;AT12;AT125;31019;Heldenberg;70_74;56;40;16;2021
AT1;AT12;AT125;31019;Heldenberg;75_79;31;18;13;2021
AT1;AT12;AT125;31019;Heldenberg;80_84;38;17;21;2021
AT1;AT12;AT125;31019;Heldenberg;85_89;26;9;17;2021
AT1;AT12;AT125;31019;Heldenberg;90_94;13;5;8;2021
AT1;AT12;AT125;31019;Heldenberg;95_;3;0;3;2021
AT1;AT12;AT125;31021;Hohenwarth-M�hlbach a. M.;0_4;50;25;25;2021
AT1;AT12;AT125;31021;Hohenwarth-M�hlbach a. M.;5_9;58;22;36;2021
AT1;AT12;AT125;31021;Hohenwarth-M�hlbach a. M.;10_14;59;20;39;2021
AT1;AT12;AT125;31021;Hohenwarth-M�hlbach a. M.;15_19;58;28;30;2021
AT1;AT12;AT125;31021;Hohenwarth-M�hlbach a. M.;20_24;64;26;38;2021
AT1;AT12;AT125;31021;Hohenwarth-M�hlbach a. M.;25_29;53;23;30;2021
AT1;AT12;AT125;31021;Hohenwarth-M�hlbach a. M.;30_34;59;32;27;2021
AT1;AT12;AT125;31021;Hohenwarth-M�hlbach a. M.;35_39;81;40;41;2021
AT1;AT12;AT125;31021;Hohenwarth-M�hlbach a. M.;40_44;108;55;53;2021
AT1;AT12;AT125;31021;Hohenwarth-M�hlbach a. M.;45_49;101;45;56;2021
AT1;AT12;AT125;31021;Hohenwarth-M�hlbach a. M.;50_54;94;48;46;2021
AT1;AT12;AT125;31021;Hohenwarth-M�hlbach a. M.;55_59;113;56;57;2021
AT1;AT12;AT125;31021;Hohenwarth-M�hlbach a. M.;60_64;116;57;59;2021
AT1;AT12;AT125;31021;Hohenwarth-M�hlbach a. M.;65_69;90;40;50;2021
AT1;AT12;AT125;31021;Hohenwarth-M�hlbach a. M.;70_74;68;40;28;2021
AT1;AT12;AT125;31021;Hohenwarth-M�hlbach a. M.;75_79;52;30;22;2021
AT1;AT12;AT125;31021;Hohenwarth-M�hlbach a. M.;80_84;51;21;30;2021
AT1;AT12;AT125;31021;Hohenwarth-M�hlbach a. M.;85_89;28;11;17;2021
AT1;AT12;AT125;31021;Hohenwarth-M�hlbach a. M.;90_94;12;5;7;2021
AT1;AT12;AT125;31021;Hohenwarth-M�hlbach a. M.;95_;5;1;4;2021
AT1;AT12;AT125;31022;Hollabrunn;0_4;541;269;272;2021
AT1;AT12;AT125;31022;Hollabrunn;5_9;556;294;262;2021
AT1;AT12;AT125;31022;Hollabrunn;10_14;513;255;258;2021
AT1;AT12;AT125;31022;Hollabrunn;15_19;551;274;277;2021
AT1;AT12;AT125;31022;Hollabrunn;20_24;660;336;324;2021
AT1;AT12;AT125;31022;Hollabrunn;25_29;744;382;362;2021
AT1;AT12;AT125;31022;Hollabrunn;30_34;733;384;349;2021
AT1;AT12;AT125;31022;Hollabrunn;35_39;788;402;386;2021
AT1;AT12;AT125;31022;Hollabrunn;40_44;726;360;366;2021
AT1;AT12;AT125;31022;Hollabrunn;45_49;839;415;424;2021
AT1;AT12;AT125;31022;Hollabrunn;50_54;927;436;491;2021
AT1;AT12;AT125;31022;Hollabrunn;55_59;1038;505;533;2021
AT1;AT12;AT125;31022;Hollabrunn;60_64;872;433;439;2021
AT1;AT12;AT125;31022;Hollabrunn;65_69;694;325;369;2021
AT1;AT12;AT125;31022;Hollabrunn;70_74;557;247;310;2021
AT1;AT12;AT125;31022;Hollabrunn;75_79;481;222;259;2021
AT1;AT12;AT125;31022;Hollabrunn;80_84;398;165;233;2021
AT1;AT12;AT125;31022;Hollabrunn;85_89;193;64;129;2021
AT1;AT12;AT125;31022;Hollabrunn;90_94;108;32;76;2021
AT1;AT12;AT125;31022;Hollabrunn;95_;25;4;21;2021
AT1;AT12;AT125;31025;Mailberg;0_4;23;11;12;2021
AT1;AT12;AT125;31025;Mailberg;5_9;21;11;10;2021
AT1;AT12;AT125;31025;Mailberg;10_14;25;12;13;2021
AT1;AT12;AT125;31025;Mailberg;15_19;32;14;18;2021
AT1;AT12;AT125;31025;Mailberg;20_24;21;13;8;2021
AT1;AT12;AT125;31025;Mailberg;25_29;30;18;12;2021
AT1;AT12;AT125;31025;Mailberg;30_34;35;19;16;2021
AT1;AT12;AT125;31025;Mailberg;35_39;23;14;9;2021
AT1;AT12;AT125;31025;Mailberg;40_44;30;14;16;2021
AT1;AT12;AT125;31025;Mailberg;45_49;37;18;19;2021
AT1;AT12;AT125;31025;Mailberg;50_54;52;28;24;2021
AT1;AT12;AT125;31025;Mailberg;55_59;43;25;18;2021
AT1;AT12;AT125;31025;Mailberg;60_64;59;28;31;2021
AT1;AT12;AT125;31025;Mailberg;65_69;38;21;17;2021
AT1;AT12;AT125;31025;Mailberg;70_74;43;19;24;2021
AT1;AT12;AT125;31025;Mailberg;75_79;9;8;1;2021
AT1;AT12;AT125;31025;Mailberg;80_84;33;11;22;2021
AT1;AT12;AT125;31025;Mailberg;85_89;22;4;18;2021
AT1;AT12;AT125;31025;Mailberg;90_94;4;2;2;2021
AT1;AT12;AT125;31025;Mailberg;95_;0;0;0;2021
AT1;AT12;AT125;31026;Maissau;0_4;77;40;37;2021
AT1;AT12;AT125;31026;Maissau;5_9;88;53;35;2021
AT1;AT12;AT125;31026;Maissau;10_14;84;41;43;2021
AT1;AT12;AT125;31026;Maissau;15_19;62;34;28;2021
AT1;AT12;AT125;31026;Maissau;20_24;98;49;49;2021
AT1;AT12;AT125;31026;Maissau;25_29;100;52;48;2021
AT1;AT12;AT125;31026;Maissau;30_34;124;61;63;2021
AT1;AT12;AT125;31026;Maissau;35_39;111;57;54;2021
AT1;AT12;AT125;31026;Maissau;40_44;115;57;58;2021
AT1;AT12;AT125;31026;Maissau;45_49;139;67;72;2021
AT1;AT12;AT125;31026;Maissau;50_54;150;79;71;2021
AT1;AT12;AT125;31026;Maissau;55_59;164;79;85;2021
AT1;AT12;AT125;31026;Maissau;60_64;161;83;78;2021
AT1;AT12;AT125;31026;Maissau;65_69;129;60;69;2021
AT1;AT12;AT125;31026;Maissau;70_74;95;47;48;2021
AT1;AT12;AT125;31026;Maissau;75_79;90;42;48;2021
AT1;AT12;AT125;31026;Maissau;80_84;88;44;44;2021
AT1;AT12;AT125;31026;Maissau;85_89;39;16;23;2021
AT1;AT12;AT125;31026;Maissau;90_94;19;3;16;2021
AT1;AT12;AT125;31026;Maissau;95_;5;1;4;2021
AT1;AT12;AT125;31028;Nappersdorf-Kammersdorf;0_4;38;15;23;2021
AT1;AT12;AT125;31028;Nappersdorf-Kammersdorf;5_9;41;26;15;2021
AT1;AT12;AT125;31028;Nappersdorf-Kammersdorf;10_14;49;27;22;2021
AT1;AT12;AT125;31028;Nappersdorf-Kammersdorf;15_19;54;32;22;2021
AT1;AT12;AT125;31028;Nappersdorf-Kammersdorf;20_24;47;29;18;2021
AT1;AT12;AT125;31028;Nappersdorf-Kammersdorf;25_29;64;33;31;2021
AT1;AT12;AT125;31028;Nappersdorf-Kammersdorf;30_34;57;30;27;2021
AT1;AT12;AT125;31028;Nappersdorf-Kammersdorf;35_39;61;28;33;2021
AT1;AT12;AT125;31028;Nappersdorf-Kammersdorf;40_44;66;30;36;2021
AT1;AT12;AT125;31028;Nappersdorf-Kammersdorf;45_49;85;42;43;2021
AT1;AT12;AT125;31028;Nappersdorf-Kammersdorf;50_54;103;52;51;2021
AT1;AT12;AT125;31028;Nappersdorf-Kammersdorf;55_59;120;66;54;2021
AT1;AT12;AT125;31028;Nappersdorf-Kammersdorf;60_64;111;49;62;2021
AT1;AT12;AT125;31028;Nappersdorf-Kammersdorf;65_69;96;55;41;2021
AT1;AT12;AT125;31028;Nappersdorf-Kammersdorf;70_74;83;40;43;2021
AT1;AT12;AT125;31028;Nappersdorf-Kammersdorf;75_79;49;23;26;2021
AT1;AT12;AT125;31028;Nappersdorf-Kammersdorf;80_84;45;23;22;2021
AT1;AT12;AT125;31028;Nappersdorf-Kammersdorf;85_89;19;12;7;2021
AT1;AT12;AT125;31028;Nappersdorf-Kammersdorf;90_94;10;2;8;2021
AT1;AT12;AT125;31028;Nappersdorf-Kammersdorf;95_;4;1;3;2021
AT1;AT12;AT125;31033;Pernersdorf;0_4;40;21;19;2021
AT1;AT12;AT125;31033;Pernersdorf;5_9;46;21;25;2021
AT1;AT12;AT125;31033;Pernersdorf;10_14;51;24;27;2021
AT1;AT12;AT125;31033;Pernersdorf;15_19;58;26;32;2021
AT1;AT12;AT125;31033;Pernersdorf;20_24;52;31;21;2021
AT1;AT12;AT125;31033;Pernersdorf;25_29;44;23;21;2021
AT1;AT12;AT125;31033;Pernersdorf;30_34;48;26;22;2021
AT1;AT12;AT125;31033;Pernersdorf;35_39;57;28;29;2021
AT1;AT12;AT125;31033;Pernersdorf;40_44;81;42;39;2021
AT1;AT12;AT125;31033;Pernersdorf;45_49;72;38;34;2021
AT1;AT12;AT125;31033;Pernersdorf;50_54;84;40;44;2021
AT1;AT12;AT125;31033;Pernersdorf;55_59;82;47;35;2021
AT1;AT12;AT125;31033;Pernersdorf;60_64;78;37;41;2021
AT1;AT12;AT125;31033;Pernersdorf;65_69;69;34;35;2021
AT1;AT12;AT125;31033;Pernersdorf;70_74;56;22;34;2021
AT1;AT12;AT125;31033;Pernersdorf;75_79;40;18;22;2021
AT1;AT12;AT125;31033;Pernersdorf;80_84;45;21;24;2021
AT1;AT12;AT125;31033;Pernersdorf;85_89;28;13;15;2021
AT1;AT12;AT125;31033;Pernersdorf;90_94;5;2;3;2021
AT1;AT12;AT125;31033;Pernersdorf;95_;4;1;3;2021
AT1;AT12;AT125;31035;Pulkau;0_4;63;38;25;2021
AT1;AT12;AT125;31035;Pulkau;5_9;68;35;33;2021
AT1;AT12;AT125;31035;Pulkau;10_14;78;42;36;2021
AT1;AT12;AT125;31035;Pulkau;15_19;69;36;33;2021
AT1;AT12;AT125;31035;Pulkau;20_24;56;32;24;2021
AT1;AT12;AT125;31035;Pulkau;25_29;67;38;29;2021
AT1;AT12;AT125;31035;Pulkau;30_34;84;47;37;2021
AT1;AT12;AT125;31035;Pulkau;35_39;66;28;38;2021
AT1;AT12;AT125;31035;Pulkau;40_44;110;50;60;2021
AT1;AT12;AT125;31035;Pulkau;45_49;108;55;53;2021
AT1;AT12;AT125;31035;Pulkau;50_54;113;59;54;2021
AT1;AT12;AT125;31035;Pulkau;55_59;125;72;53;2021
AT1;AT12;AT125;31035;Pulkau;60_64;97;46;51;2021
AT1;AT12;AT125;31035;Pulkau;65_69;97;44;53;2021
AT1;AT12;AT125;31035;Pulkau;70_74;100;43;57;2021
AT1;AT12;AT125;31035;Pulkau;75_79;88;42;46;2021
AT1;AT12;AT125;31035;Pulkau;80_84;66;25;41;2021
AT1;AT12;AT125;31035;Pulkau;85_89;32;10;22;2021
AT1;AT12;AT125;31035;Pulkau;90_94;15;4;11;2021
AT1;AT12;AT125;31035;Pulkau;95_;4;0;4;2021
AT1;AT12;AT125;31036;Ravelsbach;0_4;58;28;30;2021
AT1;AT12;AT125;31036;Ravelsbach;5_9;66;31;35;2021
AT1;AT12;AT125;31036;Ravelsbach;10_14;71;33;38;2021
AT1;AT12;AT125;31036;Ravelsbach;15_19;75;39;36;2021
AT1;AT12;AT125;31036;Ravelsbach;20_24;73;42;31;2021
AT1;AT12;AT125;31036;Ravelsbach;25_29;99;46;53;2021
AT1;AT12;AT125;31036;Ravelsbach;30_34;100;57;43;2021
AT1;AT12;AT125;31036;Ravelsbach;35_39;99;58;41;2021
AT1;AT12;AT125;31036;Ravelsbach;40_44;91;42;49;2021
AT1;AT12;AT125;31036;Ravelsbach;45_49;109;55;54;2021
AT1;AT12;AT125;31036;Ravelsbach;50_54;147;74;73;2021
AT1;AT12;AT125;31036;Ravelsbach;55_59;163;77;86;2021
AT1;AT12;AT125;31036;Ravelsbach;60_64;118;65;53;2021
AT1;AT12;AT125;31036;Ravelsbach;65_69;85;42;43;2021
AT1;AT12;AT125;31036;Ravelsbach;70_74;92;43;49;2021
AT1;AT12;AT125;31036;Ravelsbach;75_79;67;31;36;2021
AT1;AT12;AT125;31036;Ravelsbach;80_84;73;32;41;2021
AT1;AT12;AT125;31036;Ravelsbach;85_89;25;12;13;2021
AT1;AT12;AT125;31036;Ravelsbach;90_94;15;4;11;2021
AT1;AT12;AT125;31036;Ravelsbach;95_;5;1;4;2021
AT1;AT12;AT125;31037;Retz;0_4;149;75;74;2021
AT1;AT12;AT125;31037;Retz;5_9;186;101;85;2021
AT1;AT12;AT125;31037;Retz;10_14;162;90;72;2021
AT1;AT12;AT125;31037;Retz;15_19;184;98;86;2021
AT1;AT12;AT125;31037;Retz;20_24;220;115;105;2021
AT1;AT12;AT125;31037;Retz;25_29;254;142;112;2021
AT1;AT12;AT125;31037;Retz;30_34;204;112;92;2021
AT1;AT12;AT125;31037;Retz;35_39;236;118;118;2021
AT1;AT12;AT125;31037;Retz;40_44;244;120;124;2021
AT1;AT12;AT125;31037;Retz;45_49;284;148;136;2021
AT1;AT12;AT125;31037;Retz;50_54;352;182;170;2021
AT1;AT12;AT125;31037;Retz;55_59;369;182;187;2021
AT1;AT12;AT125;31037;Retz;60_64;324;176;148;2021
AT1;AT12;AT125;31037;Retz;65_69;251;135;116;2021
AT1;AT12;AT125;31037;Retz;70_74;239;109;130;2021
AT1;AT12;AT125;31037;Retz;75_79;188;80;108;2021
AT1;AT12;AT125;31037;Retz;80_84;194;84;110;2021
AT1;AT12;AT125;31037;Retz;85_89;118;42;76;2021
AT1;AT12;AT125;31037;Retz;90_94;57;8;49;2021
AT1;AT12;AT125;31037;Retz;95_;25;4;21;2021
AT1;AT12;AT125;31038;Retzbach;0_4;42;19;23;2021
AT1;AT12;AT125;31038;Retzbach;5_9;34;13;21;2021
AT1;AT12;AT125;31038;Retzbach;10_14;48;24;24;2021
AT1;AT12;AT125;31038;Retzbach;15_19;57;30;27;2021
AT1;AT12;AT125;31038;Retzbach;20_24;54;31;23;2021
AT1;AT12;AT125;31038;Retzbach;25_29;44;19;25;2021
AT1;AT12;AT125;31038;Retzbach;30_34;53;32;21;2021
AT1;AT12;AT125;31038;Retzbach;35_39;48;21;27;2021
AT1;AT12;AT125;31038;Retzbach;40_44;49;25;24;2021
AT1;AT12;AT125;31038;Retzbach;45_49;77;34;43;2021
AT1;AT12;AT125;31038;Retzbach;50_54;74;33;41;2021
AT1;AT12;AT125;31038;Retzbach;55_59;87;51;36;2021
AT1;AT12;AT125;31038;Retzbach;60_64;73;36;37;2021
AT1;AT12;AT125;31038;Retzbach;65_69;69;34;35;2021
AT1;AT12;AT125;31038;Retzbach;70_74;58;22;36;2021
AT1;AT12;AT125;31038;Retzbach;75_79;50;20;30;2021
AT1;AT12;AT125;31038;Retzbach;80_84;43;19;24;2021
AT1;AT12;AT125;31038;Retzbach;85_89;37;12;25;2021
AT1;AT12;AT125;31038;Retzbach;90_94;13;3;10;2021
AT1;AT12;AT125;31038;Retzbach;95_;2;1;1;2021
AT1;AT12;AT125;31041;Schrattenthal;0_4;43;22;21;2021
AT1;AT12;AT125;31041;Schrattenthal;5_9;40;23;17;2021
AT1;AT12;AT125;31041;Schrattenthal;10_14;49;21;28;2021
AT1;AT12;AT125;31041;Schrattenthal;15_19;43;21;22;2021
AT1;AT12;AT125;31041;Schrattenthal;20_24;39;23;16;2021
AT1;AT12;AT125;31041;Schrattenthal;25_29;43;20;23;2021
AT1;AT12;AT125;31041;Schrattenthal;30_34;37;22;15;2021
AT1;AT12;AT125;31041;Schrattenthal;35_39;52;24;28;2021
AT1;AT12;AT125;31041;Schrattenthal;40_44;60;27;33;2021
AT1;AT12;AT125;31041;Schrattenthal;45_49;60;30;30;2021
AT1;AT12;AT125;31041;Schrattenthal;50_54;73;38;35;2021
AT1;AT12;AT125;31041;Schrattenthal;55_59;79;40;39;2021
AT1;AT12;AT125;31041;Schrattenthal;60_64;60;32;28;2021
AT1;AT12;AT125;31041;Schrattenthal;65_69;54;28;26;2021
AT1;AT12;AT125;31041;Schrattenthal;70_74;54;22;32;2021
AT1;AT12;AT125;31041;Schrattenthal;75_79;37;20;17;2021
AT1;AT12;AT125;31041;Schrattenthal;80_84;41;19;22;2021
AT1;AT12;AT125;31041;Schrattenthal;85_89;24;9;15;2021
AT1;AT12;AT125;31041;Schrattenthal;90_94;5;2;3;2021
AT1;AT12;AT125;31041;Schrattenthal;95_;1;1;0;2021
AT1;AT12;AT125;31042;Seefeld-Kadolz;0_4;41;25;16;2021
AT1;AT12;AT125;31042;Seefeld-Kadolz;5_9;36;21;15;2021
AT1;AT12;AT125;31042;Seefeld-Kadolz;10_14;36;22;14;2021
AT1;AT12;AT125;31042;Seefeld-Kadolz;15_19;50;25;25;2021
AT1;AT12;AT125;31042;Seefeld-Kadolz;20_24;37;17;20;2021
AT1;AT12;AT125;31042;Seefeld-Kadolz;25_29;50;24;26;2021
AT1;AT12;AT125;31042;Seefeld-Kadolz;30_34;41;22;19;2021
AT1;AT12;AT125;31042;Seefeld-Kadolz;35_39;59;30;29;2021
AT1;AT12;AT125;31042;Seefeld-Kadolz;40_44;47;19;28;2021
AT1;AT12;AT125;31042;Seefeld-Kadolz;45_49;52;28;24;2021
AT1;AT12;AT125;31042;Seefeld-Kadolz;50_54;74;39;35;2021
AT1;AT12;AT125;31042;Seefeld-Kadolz;55_59;92;45;47;2021
AT1;AT12;AT125;31042;Seefeld-Kadolz;60_64;96;50;46;2021
AT1;AT12;AT125;31042;Seefeld-Kadolz;65_69;84;52;32;2021
AT1;AT12;AT125;31042;Seefeld-Kadolz;70_74;63;24;39;2021
AT1;AT12;AT125;31042;Seefeld-Kadolz;75_79;44;21;23;2021
AT1;AT12;AT125;31042;Seefeld-Kadolz;80_84;46;19;27;2021
AT1;AT12;AT125;31042;Seefeld-Kadolz;85_89;22;5;17;2021
AT1;AT12;AT125;31042;Seefeld-Kadolz;90_94;9;5;4;2021
AT1;AT12;AT125;31042;Seefeld-Kadolz;95_;3;1;2;2021
AT1;AT12;AT125;31043;Sitzendorf an der Schmida;0_4;95;42;53;2021
AT1;AT12;AT125;31043;Sitzendorf an der Schmida;5_9;102;61;41;2021
AT1;AT12;AT125;31043;Sitzendorf an der Schmida;10_14;78;42;36;2021
AT1;AT12;AT125;31043;Sitzendorf an der Schmida;15_19;113;61;52;2021
AT1;AT12;AT125;31043;Sitzendorf an der Schmida;20_24;115;67;48;2021
AT1;AT12;AT125;31043;Sitzendorf an der Schmida;25_29;93;48;45;2021
AT1;AT12;AT125;31043;Sitzendorf an der Schmida;30_34;107;57;50;2021
AT1;AT12;AT125;31043;Sitzendorf an der Schmida;35_39;107;47;60;2021
AT1;AT12;AT125;31043;Sitzendorf an der Schmida;40_44;136;69;67;2021
AT1;AT12;AT125;31043;Sitzendorf an der Schmida;45_49;147;76;71;2021
AT1;AT12;AT125;31043;Sitzendorf an der Schmida;50_54;189;101;88;2021
AT1;AT12;AT125;31043;Sitzendorf an der Schmida;55_59;187;101;86;2021
AT1;AT12;AT125;31043;Sitzendorf an der Schmida;60_64;165;92;73;2021
AT1;AT12;AT125;31043;Sitzendorf an der Schmida;65_69;127;60;67;2021
AT1;AT12;AT125;31043;Sitzendorf an der Schmida;70_74;129;50;79;2021
AT1;AT12;AT125;31043;Sitzendorf an der Schmida;75_79;85;37;48;2021
AT1;AT12;AT125;31043;Sitzendorf an der Schmida;80_84;103;48;55;2021
AT1;AT12;AT125;31043;Sitzendorf an der Schmida;85_89;49;26;23;2021
AT1;AT12;AT125;31043;Sitzendorf an der Schmida;90_94;9;3;6;2021
AT1;AT12;AT125;31043;Sitzendorf an der Schmida;95_;7;0;7;2021
AT1;AT12;AT125;31051;Wullersdorf;0_4;112;57;55;2021
AT1;AT12;AT125;31051;Wullersdorf;5_9;111;56;55;2021
AT1;AT12;AT125;31051;Wullersdorf;10_14;94;46;48;2021
AT1;AT12;AT125;31051;Wullersdorf;15_19;119;64;55;2021
AT1;AT12;AT125;31051;Wullersdorf;20_24;121;61;60;2021
AT1;AT12;AT125;31051;Wullersdorf;25_29;141;71;70;2021
AT1;AT12;AT125;31051;Wullersdorf;30_34;148;72;76;2021
AT1;AT12;AT125;31051;Wullersdorf;35_39;138;69;69;2021
AT1;AT12;AT125;31051;Wullersdorf;40_44;127;64;63;2021
AT1;AT12;AT125;31051;Wullersdorf;45_49;191;100;91;2021
AT1;AT12;AT125;31051;Wullersdorf;50_54;206;109;97;2021
AT1;AT12;AT125;31051;Wullersdorf;55_59;196;104;92;2021
AT1;AT12;AT125;31051;Wullersdorf;60_64;176;90;86;2021
AT1;AT12;AT125;31051;Wullersdorf;65_69;142;74;68;2021
AT1;AT12;AT125;31051;Wullersdorf;70_74;158;74;84;2021
AT1;AT12;AT125;31051;Wullersdorf;75_79;77;38;39;2021
AT1;AT12;AT125;31051;Wullersdorf;80_84;78;28;50;2021
AT1;AT12;AT125;31051;Wullersdorf;85_89;44;16;28;2021
AT1;AT12;AT125;31051;Wullersdorf;90_94;7;1;6;2021
AT1;AT12;AT125;31051;Wullersdorf;95_;0;0;0;2021
AT1;AT12;AT125;31052;Zellerndorf;0_4;110;54;56;2021
AT1;AT12;AT125;31052;Zellerndorf;5_9;90;47;43;2021
AT1;AT12;AT125;31052;Zellerndorf;10_14;96;49;47;2021
AT1;AT12;AT125;31052;Zellerndorf;15_19;117;76;41;2021
AT1;AT12;AT125;31052;Zellerndorf;20_24;116;63;53;2021
AT1;AT12;AT125;31052;Zellerndorf;25_29;132;67;65;2021
AT1;AT12;AT125;31052;Zellerndorf;30_34;126;68;58;2021
AT1;AT12;AT125;31052;Zellerndorf;35_39;157;74;83;2021
AT1;AT12;AT125;31052;Zellerndorf;40_44;139;74;65;2021
AT1;AT12;AT125;31052;Zellerndorf;45_49;170;86;84;2021
AT1;AT12;AT125;31052;Zellerndorf;50_54;201;101;100;2021
AT1;AT12;AT125;31052;Zellerndorf;55_59;220;125;95;2021
AT1;AT12;AT125;31052;Zellerndorf;60_64;166;75;91;2021
AT1;AT12;AT125;31052;Zellerndorf;65_69;188;92;96;2021
AT1;AT12;AT125;31052;Zellerndorf;70_74;143;79;64;2021
AT1;AT12;AT125;31052;Zellerndorf;75_79;89;29;60;2021
AT1;AT12;AT125;31052;Zellerndorf;80_84;99;47;52;2021
AT1;AT12;AT125;31052;Zellerndorf;85_89;43;16;27;2021
AT1;AT12;AT125;31052;Zellerndorf;90_94;18;6;12;2021
AT1;AT12;AT125;31052;Zellerndorf;95_;4;0;4;2021
AT1;AT12;AT125;31053;Ziersdorf;0_4;136;74;62;2021
AT1;AT12;AT125;31053;Ziersdorf;5_9;170;89;81;2021
AT1;AT12;AT125;31053;Ziersdorf;10_14;146;72;74;2021
AT1;AT12;AT125;31053;Ziersdorf;15_19;166;96;70;2021
AT1;AT12;AT125;31053;Ziersdorf;20_24;177;87;90;2021
AT1;AT12;AT125;31053;Ziersdorf;25_29;165;78;87;2021
AT1;AT12;AT125;31053;Ziersdorf;30_34;178;85;93;2021
AT1;AT12;AT125;31053;Ziersdorf;35_39;201;104;97;2021
AT1;AT12;AT125;31053;Ziersdorf;40_44;205;99;106;2021
AT1;AT12;AT125;31053;Ziersdorf;45_49;263;129;134;2021
AT1;AT12;AT125;31053;Ziersdorf;50_54;306;155;151;2021
AT1;AT12;AT125;31053;Ziersdorf;55_59;302;163;139;2021
AT1;AT12;AT125;31053;Ziersdorf;60_64;257;125;132;2021
AT1;AT12;AT125;31053;Ziersdorf;65_69;182;94;88;2021
AT1;AT12;AT125;31053;Ziersdorf;70_74;181;81;100;2021
AT1;AT12;AT125;31053;Ziersdorf;75_79;106;47;59;2021
AT1;AT12;AT125;31053;Ziersdorf;80_84;114;43;71;2021
AT1;AT12;AT125;31053;Ziersdorf;85_89;60;25;35;2021
AT1;AT12;AT125;31053;Ziersdorf;90_94;27;5;22;2021
AT1;AT12;AT125;31053;Ziersdorf;95_;3;1;2;2021
AT1;AT12;AT124;31101;Altenburg;0_4;39;17;22;2021
AT1;AT12;AT124;31101;Altenburg;5_9;41;22;19;2021
AT1;AT12;AT124;31101;Altenburg;10_14;39;16;23;2021
AT1;AT12;AT124;31101;Altenburg;15_19;51;26;25;2021
AT1;AT12;AT124;31101;Altenburg;20_24;46;23;23;2021
AT1;AT12;AT124;31101;Altenburg;25_29;35;20;15;2021
AT1;AT12;AT124;31101;Altenburg;30_34;54;30;24;2021
AT1;AT12;AT124;31101;Altenburg;35_39;42;21;21;2021
AT1;AT12;AT124;31101;Altenburg;40_44;42;16;26;2021
AT1;AT12;AT124;31101;Altenburg;45_49;61;32;29;2021
AT1;AT12;AT124;31101;Altenburg;50_54;57;28;29;2021
AT1;AT12;AT124;31101;Altenburg;55_59;77;43;34;2021
AT1;AT12;AT124;31101;Altenburg;60_64;55;24;31;2021
AT1;AT12;AT124;31101;Altenburg;65_69;59;32;27;2021
AT1;AT12;AT124;31101;Altenburg;70_74;30;18;12;2021
AT1;AT12;AT124;31101;Altenburg;75_79;19;7;12;2021
AT1;AT12;AT124;31101;Altenburg;80_84;29;11;18;2021
AT1;AT12;AT124;31101;Altenburg;85_89;18;12;6;2021
AT1;AT12;AT124;31101;Altenburg;90_94;6;2;4;2021
AT1;AT12;AT124;31101;Altenburg;95_;1;1;0;2021
AT1;AT12;AT124;31102;Brunn an der Wild;0_4;50;29;21;2021
AT1;AT12;AT124;31102;Brunn an der Wild;5_9;40;21;19;2021
AT1;AT12;AT124;31102;Brunn an der Wild;10_14;33;13;20;2021
AT1;AT12;AT124;31102;Brunn an der Wild;15_19;43;21;22;2021
AT1;AT12;AT124;31102;Brunn an der Wild;20_24;33;15;18;2021
AT1;AT12;AT124;31102;Brunn an der Wild;25_29;37;13;24;2021
AT1;AT12;AT124;31102;Brunn an der Wild;30_34;55;27;28;2021
AT1;AT12;AT124;31102;Brunn an der Wild;35_39;60;31;29;2021
AT1;AT12;AT124;31102;Brunn an der Wild;40_44;57;29;28;2021
AT1;AT12;AT124;31102;Brunn an der Wild;45_49;60;29;31;2021
AT1;AT12;AT124;31102;Brunn an der Wild;50_54;52;26;26;2021
AT1;AT12;AT124;31102;Brunn an der Wild;55_59;76;29;47;2021
AT1;AT12;AT124;31102;Brunn an der Wild;60_64;62;37;25;2021
AT1;AT12;AT124;31102;Brunn an der Wild;65_69;65;32;33;2021
AT1;AT12;AT124;31102;Brunn an der Wild;70_74;41;23;18;2021
AT1;AT12;AT124;31102;Brunn an der Wild;75_79;33;19;14;2021
AT1;AT12;AT124;31102;Brunn an der Wild;80_84;26;14;12;2021
AT1;AT12;AT124;31102;Brunn an der Wild;85_89;12;3;9;2021
AT1;AT12;AT124;31102;Brunn an der Wild;90_94;7;1;6;2021
AT1;AT12;AT124;31102;Brunn an der Wild;95_;2;1;1;2021
AT1;AT12;AT124;31103;Burgschleinitz-K�hnring;0_4;49;27;22;2021
AT1;AT12;AT124;31103;Burgschleinitz-K�hnring;5_9;53;26;27;2021
AT1;AT12;AT124;31103;Burgschleinitz-K�hnring;10_14;69;42;27;2021
AT1;AT12;AT124;31103;Burgschleinitz-K�hnring;15_19;77;40;37;2021
AT1;AT12;AT124;31103;Burgschleinitz-K�hnring;20_24;67;35;32;2021
AT1;AT12;AT124;31103;Burgschleinitz-K�hnring;25_29;74;41;33;2021
AT1;AT12;AT124;31103;Burgschleinitz-K�hnring;30_34;67;41;26;2021
AT1;AT12;AT124;31103;Burgschleinitz-K�hnring;35_39;84;47;37;2021
AT1;AT12;AT124;31103;Burgschleinitz-K�hnring;40_44;91;43;48;2021
AT1;AT12;AT124;31103;Burgschleinitz-K�hnring;45_49;97;51;46;2021
AT1;AT12;AT124;31103;Burgschleinitz-K�hnring;50_54;104;53;51;2021
AT1;AT12;AT124;31103;Burgschleinitz-K�hnring;55_59;123;69;54;2021
AT1;AT12;AT124;31103;Burgschleinitz-K�hnring;60_64;120;61;59;2021
AT1;AT12;AT124;31103;Burgschleinitz-K�hnring;65_69;86;46;40;2021
AT1;AT12;AT124;31103;Burgschleinitz-K�hnring;70_74;45;22;23;2021
AT1;AT12;AT124;31103;Burgschleinitz-K�hnring;75_79;45;20;25;2021
AT1;AT12;AT124;31103;Burgschleinitz-K�hnring;80_84;44;20;24;2021
AT1;AT12;AT124;31103;Burgschleinitz-K�hnring;85_89;31;13;18;2021
AT1;AT12;AT124;31103;Burgschleinitz-K�hnring;90_94;9;3;6;2021
AT1;AT12;AT124;31103;Burgschleinitz-K�hnring;95_;2;0;2;2021
AT1;AT12;AT124;31104;Drosendorf-Zissersdorf;0_4;47;27;20;2021
AT1;AT12;AT124;31104;Drosendorf-Zissersdorf;5_9;50;24;26;2021
AT1;AT12;AT124;31104;Drosendorf-Zissersdorf;10_14;61;33;28;2021
AT1;AT12;AT124;31104;Drosendorf-Zissersdorf;15_19;57;23;34;2021
AT1;AT12;AT124;31104;Drosendorf-Zissersdorf;20_24;40;24;16;2021
AT1;AT12;AT124;31104;Drosendorf-Zissersdorf;25_29;61;32;29;2021
AT1;AT12;AT124;31104;Drosendorf-Zissersdorf;30_34;63;32;31;2021
AT1;AT12;AT124;31104;Drosendorf-Zissersdorf;35_39;58;29;29;2021
AT1;AT12;AT124;31104;Drosendorf-Zissersdorf;40_44;51;18;33;2021
AT1;AT12;AT124;31104;Drosendorf-Zissersdorf;45_49;76;34;42;2021
AT1;AT12;AT124;31104;Drosendorf-Zissersdorf;50_54;103;49;54;2021
AT1;AT12;AT124;31104;Drosendorf-Zissersdorf;55_59;94;57;37;2021
AT1;AT12;AT124;31104;Drosendorf-Zissersdorf;60_64;98;51;47;2021
AT1;AT12;AT124;31104;Drosendorf-Zissersdorf;65_69;77;37;40;2021
AT1;AT12;AT124;31104;Drosendorf-Zissersdorf;70_74;83;41;42;2021
AT1;AT12;AT124;31104;Drosendorf-Zissersdorf;75_79;58;25;33;2021
AT1;AT12;AT124;31104;Drosendorf-Zissersdorf;80_84;82;37;45;2021
AT1;AT12;AT124;31104;Drosendorf-Zissersdorf;85_89;32;10;22;2021
AT1;AT12;AT124;31104;Drosendorf-Zissersdorf;90_94;14;7;7;2021
AT1;AT12;AT124;31104;Drosendorf-Zissersdorf;95_;2;0;2;2021
AT1;AT12;AT124;31105;Eggenburg;0_4;148;75;73;2021
AT1;AT12;AT124;31105;Eggenburg;5_9;136;66;70;2021
AT1;AT12;AT124;31105;Eggenburg;10_14;158;68;90;2021
AT1;AT12;AT124;31105;Eggenburg;15_19;182;98;84;2021
AT1;AT12;AT124;31105;Eggenburg;20_24;164;99;65;2021
AT1;AT12;AT124;31105;Eggenburg;25_29;176;94;82;2021
AT1;AT12;AT124;31105;Eggenburg;30_34;199;100;99;2021
AT1;AT12;AT124;31105;Eggenburg;35_39;191;90;101;2021
AT1;AT12;AT124;31105;Eggenburg;40_44;191;104;87;2021
AT1;AT12;AT124;31105;Eggenburg;45_49;205;105;100;2021
AT1;AT12;AT124;31105;Eggenburg;50_54;243;98;145;2021
AT1;AT12;AT124;31105;Eggenburg;55_59;308;167;141;2021
AT1;AT12;AT124;31105;Eggenburg;60_64;249;112;137;2021
AT1;AT12;AT124;31105;Eggenburg;65_69;229;104;125;2021
AT1;AT12;AT124;31105;Eggenburg;70_74;210;107;103;2021
AT1;AT12;AT124;31105;Eggenburg;75_79;157;71;86;2021
AT1;AT12;AT124;31105;Eggenburg;80_84;171;65;106;2021
AT1;AT12;AT124;31105;Eggenburg;85_89;95;36;59;2021
AT1;AT12;AT124;31105;Eggenburg;90_94;39;5;34;2021
AT1;AT12;AT124;31105;Eggenburg;95_;14;3;11;2021
AT1;AT12;AT124;31106;Gars am Kamp;0_4;141;78;63;2021
AT1;AT12;AT124;31106;Gars am Kamp;5_9;136;77;59;2021
AT1;AT12;AT124;31106;Gars am Kamp;10_14;131;68;63;2021
AT1;AT12;AT124;31106;Gars am Kamp;15_19;167;87;80;2021
AT1;AT12;AT124;31106;Gars am Kamp;20_24;151;88;63;2021
AT1;AT12;AT124;31106;Gars am Kamp;25_29;176;94;82;2021
AT1;AT12;AT124;31106;Gars am Kamp;30_34;186;92;94;2021
AT1;AT12;AT124;31106;Gars am Kamp;35_39;181;95;86;2021
AT1;AT12;AT124;31106;Gars am Kamp;40_44;179;84;95;2021
AT1;AT12;AT124;31106;Gars am Kamp;45_49;224;109;115;2021
AT1;AT12;AT124;31106;Gars am Kamp;50_54;287;136;151;2021
AT1;AT12;AT124;31106;Gars am Kamp;55_59;334;170;164;2021
AT1;AT12;AT124;31106;Gars am Kamp;60_64;277;131;146;2021
AT1;AT12;AT124;31106;Gars am Kamp;65_69;243;115;128;2021
AT1;AT12;AT124;31106;Gars am Kamp;70_74;213;101;112;2021
AT1;AT12;AT124;31106;Gars am Kamp;75_79;164;75;89;2021
AT1;AT12;AT124;31106;Gars am Kamp;80_84;159;66;93;2021
AT1;AT12;AT124;31106;Gars am Kamp;85_89;71;20;51;2021
AT1;AT12;AT124;31106;Gars am Kamp;90_94;45;14;31;2021
AT1;AT12;AT124;31106;Gars am Kamp;95_;7;2;5;2021
AT1;AT12;AT124;31107;Geras;0_4;59;27;32;2021
AT1;AT12;AT124;31107;Geras;5_9;54;36;18;2021



